一	a_
不	b_
产	c_
的	d_
而	e_
发	f_
个	g_
和	h_
以	i_
经	j_
可	k_
了	l_
民	m_
年	n_
品	p_
全	q_
人	r_
是	s_
他	t_
于	u_
中	v_
为	w_
我	o_
新	x_
有	y_
在	z_
安	a;
部	b;
出	c;
大	d;
也	e;
方	f;
国	g;
会	h;
济	i;
开	k;
家	j;
来	l;
们	m;
月	n;
欧	o;
平	p;
企	q;
日	r;
上	s;
同	t;
与	u;
这	v;
外	w;
小	x;
要	y;
作	z;
案	aa_
癌	ab_
哀	ad_
按	ae_
澳	af_
敖	ah_
奥	ai_
铵	aj_
啊	ak_
艾	al_
桉	am_
胺	an_
乃	ao_
阿	ap_
氨	aq_
暗	ar_
岸	as_
埃	at_
霭	au_
爱	av_
瑷	aw_
懊	ax_
盎	ay_
丙	ba_
比	bb_
彼	bc_
奔	bd_
报	be_
波	bf_
宝	bg_
表	bh_
被	bi_
并	bj_
贝	bk_
本	bm_
胞	bn_
巴	bo_
版	bp_
兵	bq_
保	br_
博	bs_
坝	bt_
北	bu_
步	bv_
备	bw_
必	bx_
谤	by_
鼻	bz_
厂	ca_
痴	cb_
彻	cc_
充	cd_
持	ce_
潮	cf_
察	cg_
程	ch_
长	ci_
差	cj_
承	cl_
查	cm_
创	cn_
纯	co_
除	cp_
车	cq_
传	cr_
础	cs_
场	ct_
常	cu_
船	cv_
成	cw_
穿	cx_
诚	cy_
超	cz_
甸	db_
得	dc_
贷	dd_
导	de_
段	df_
定	dg_
带	dh_
岛	di_
单	dj_
吨	dk_
董	dl_
档	dm_
胆	dn_
断	do_
队	dp_
东	dq_
电	dr_
督	ds_
地	dt_
当	du_
到	dv_
冬	dw_
多	dx_
对	dy_
跌	dz_
三	ea_
瘙	eb_
厄	ec_
死	ed_
额	ee_
所	ef_
赛	eg_
素	eh_
色	ei_
锁	ej_
四	ek_
苏	el_
松	em_
肃	en_
随	ep_
斯	eq_
俄	er_
岁	es_
思	et_
业	eu_
速	ev_
鹅	ew_
粟	ex_
诉	ey_
孙	ez_
副	fa_
分	fb_
辅	fc_
非	fe_
法	ff_
府	fg_
房	fh_
风	fi_
幅	fj_
啡	fk_
范	fl_
繁	fm_
服	fn_
飞	fo_
防	fp_
犯	fq_
份	fr_
峰	fs_
坊	ft_
霏	fu_
符	fv_
珐	fw_
覆	fx_
访	fy_
赴	fz_
工	ga_
公	gb_
轨	gc_
高	gd_
搞	ge_
规	gf_
功	gg_
共	gh_
改	gi_
关	gj_
固	gk_
甘	gl_
格	gm_
革	gn_
给	go_
隔	gp_
狗	gq_
古	gs_
圭	gt_
光	gu_
过	gv_
各	gw_
感	gx_
观	gy_
赶	gz_
画	ha_
皇	hb_
很	hc_
户	hd_
护	he_
后	hf_
或	hg_
惠	hh_
乎	hi_
含	hj_
回	hk_
花	hl_
核	hm_
好	hn_
红	ho_
隍	hp_
狠	hq_
韩	hs_
坏	ht_
黑	hu_
还	hv_
环	hw_
怀	hx_
话	hy_
孩	hz_
夷	ia_
疾	ib_
急	ic_
义	id_
技	ie_
宜	ig_
积	ih_
及	ii_
益	ij_
医	ik_
艺	il_
机	im_
肌	in_
际	ip_
基	iq_
亿	ir_
吉	is_
圾	it_
翼	iu_
集	iv_
玑	iw_
忆	ix_
记	iy_
跻	iz_
柬	ja_
皆	jb_
较	jc_
京	jd_
接	je_
江	jf_
肩	jh_
久	ji_
就	jj_
见	jk_
加	jl_
间	jm_
她	jn_
结	jo_
降	jp_
救	jq_
金	jr_
届	js_
界	jt_
坚	ju_
进	jv_
瑾	jw_
教	jx_
讲	jy_
践	jz_
疴	kb_
轲	kc_
夸	kd_
控	ke_
看	kf_
克	kg_
科	kh_
裤	ki_
况	kj_
口	kk_
考	kl_
阔	km_
脍	kn_
绔	ko_
隗	kp_
狂	kq_
昆	kr_
款	ks_
块	kt_
鲲	ku_
肯	kv_
珂	kw_
快	kx_
调	ky_
跨	kz_
两	la_
疗	lb_
律	lc_
立	ld_
联	le_
流	lf_
勒	lg_
利	lh_
乐	li_
兰	lj_
另	lk_
领	ll_
林	lm_
脸	ln_
力	lo_
陆	lp_
猎	lq_
里	lr_
乱	ls_
略	lt_
临	lu_
连	lv_
辣	lx_
论	ly_
路	lz_
末	ma_
髦	mb_
蚂	mc_
门	md_
摸	me_
每	mf_
某	mg_
面	mh_
贸	mi_
美	mj_
目	mk_
蒙	ml_
模	mm_
牧	mn_
马	mo_
陌	mp_
猛	mq_
卖	ms_
埋	mt_
霉	mu_
迈	mv_
盲	mw_
名	mx_
谋	my_
孟	mz_
才	na_
财	nb_
厕	nc_
残	nd_
能	ne_
测	nf_
农	ng_
存	nh_
次	nj_
内	nk_
菜	nl_
村	nm_
您	nn_
女	no_
陧	np_
岳	nq_
从	nr_
南	ns_
男	nt_
餐	nu_
此	nv_
弄	nw_
惨	nx_
难	ny_
越	nz_
握	oe_
沤	of_
呕	ok_
藕	ol_
纡	oo_
偶	or_
遇	ov_
怄	ox_
讴	oy_
判	pb_
徘	pc_
旁	pd_
批	pe_
派	pf_
炮	ph_
片	pi_
普	pj_
啤	pk_
葡	pl_
骗	pm_
朋	pn_
皮	po_
牌	pp_
乒	pq_
偏	pr_
破	ps_
培	pt_
霹	pu_
篇	pv_
璞	pw_
票	px_
配	py_
跑	pz_
求	qa_
泉	qb_
轻	qc_
奇	qd_
取	qe_
气	qf_
强	qg_
其	qh_
千	qi_
前	qj_
区	qk_
亲	ql_
权	qm_
腔	qn_
顷	qo_
阡	qp_
期	qq_
确	qs_
去	qt_
鳍	qu_
签	qv_
球	qw_
情	qx_
请	qy_
起	qz_
融	ra_
髯	rb_
软	rc_
刃	rd_
扰	re_
润	rf_
弱	rg_
燃	rh_
入	ri_
染	rj_
荣	rl_
柔	rm_
如	rn_
绕	ro_
阮	rp_
壬	rq_
任	rr_
嵘	rs_
壤	rt_
睿	ru_
热	rv_
瑞	rw_
容	rx_
认	ry_
孺	rz_
事	sa_
瘦	sb_
输	sc_
市	sd_
式	se_
施	sf_
实	sg_
税	sh_
手	si_
水	sj_
史	sk_
数	sl_
术	sm_
生	sn_
收	so_
陕	sp_
树	sq_
时	sr_
省	ss_
墒	st_
受	sv_
珊	sw_
少	sx_
说	sy_
跚	sz_
天	ta_
贴	tb_
厅	tc_
太	td_
提	te_
替	tf_
它	tg_
泰	th_
兔	ti_
头	tj_
童	tl_
糖	tm_
特	tn_
统	to_
陶	tp_
獭	tq_
体	tr_
题	ts_
态	tt_
堂	tu_
通	tv_
条	tw_
突	tx_
谈	ty_
跳	tz_
句	ub_
御	uc_
育	ud_
据	ue_
渔	uf_
欲	ug_
炬	uh_
鱼	ui_
锯	uj_
巨	uk_
菊	ul_
桔	um_
娱	un_
予	uo_
隅	up_
聚	uq_
余	ur_
局	us_
域	ut_
具	uu_
玉	uw_
举	ux_
语	uy_
距	uz_
正	va_
症	vb_
转	vc_
主	vd_
专	ve_
制	vf_
张	vg_
种	vh_
争	vi_
着	vj_
只	vk_
者	vl_
植	vm_
胀	vn_
织	vo_
障	vp_
助	vq_
值	vr_
展	vs_
圳	vt_
占	vu_
政	vv_
珠	vw_
窄	vx_
证	vy_
赵	vz_
万	wa_
乌	wb_
往	wc_
文	wd_
无	we_
湾	wf_
完	wg_
委	wh_
危	wi_
帷	wj_
围	wk_
芜	wl_
问	wm_
物	wn_
维	wo_
卫	wp_
猥	wq_
位	wr_
屋	ws_
胃	wt_
雾	wu_
违	wv_
务	ww_
误	wy_
下	xa_
旬	xb_
行	xc_
心	xd_
携	xe_
消	xf_
项	xg_
香	xh_
向	xi_
学	xj_
形	xk_
辛	xl_
相	xm_
些	xn_
乡	xo_
限	xp_
县	xq_
信	xr_
协	xs_
幸	xt_
需	xu_
选	xv_
现	xw_
性	xx_
许	xy_
息	xz_
亚	ya_
颖	yb_
原	yc_
言	yd_
元	ye_
源	yf_
应	yg_
严	yh_
用	yi_
影	yj_
员	yk_
营	yl_
样	ym_
盈	yn_
又	yo_
院	yp_
犹	yq_
由	yr_
研	ys_
盐	yt_
鱿	yu_
运	yv_
赢	yw_
愿	yy_
踊	yz_
再	za_
则	zb_
邹	zc_
祖	zd_
罪	ze_
族	zf_
字	zg_
责	zh_
自	zi_
总	zj_
足	zk_
子	zl_
籽	zm_
资	zn_
组	zo_
阻	zp_
载	zs_
增	zt_
鲻	zu_
造	zv_
臧	zw_
赞	zx_
醉	zy_
踪	zz_
獒	aad_
聱	aae_
鳌	aai_
熬	aaj_
骜	aam_
鏊	aar_
干	aas_
螯	aav_
翱	abd_
皑	abs_
广	adc_
鹌	add_
捱	aec_
挨	aee_
揞	ael_
拗	aey_
浇	afh_
庵	ag_
鞍	agg_
廒	agh_
顸	aghb
黯	ahl_
盒	ahm_
袄	aii_
锿	ajd_
钳	ajg_
锕	ajp_
呃	akc_
呵	akd_
唉	ake_
嗷	akh_
嗄	akhw
噢	aki_
嗌	akj_
吖	akju
嚣	akk_
哎	akl_
呆	akm_
凹	ako_
嗳	akv_
噫	aky_
鏖	alr_
蔼	aly_
阂	amd_
棍	amr_
肮	and_
腌	ynd_
媪	anr_
嫒	anv_
隘	apj_
犴	aqa_
俺	ard_
傲	arh_
昂	ari_
仰	yri_
暧	arv_
崖	asc_
矮	ash_
剀	asi_
砹	asl_
碍	asr_
埯	atd_
坳	aty_
遨	avh_
谙	ayl_
岙	ayu_
病	bba_
疤	bbb_
毖	bbbd
毙	bbd_
襞	bbdi
包	bbe_
败	bbf_
魄	pbf_
弊	bbg_
鬓	bbgb
煲	bbh_
频	pbh_
贬	bbi_
鳖	bbia
甭	qbi_
帮	bbj_
帛	bbjg
蹩	bbk_
勃	bbl_
刨	bblj
檗	bbm_
背	bbn_
鹁	bbna
鹎	bbna2
臂	bbnh
嬖	bbnh2
邴	bbp_
邶	bbpu
鐾	bbr_
毕	bbs_
擘	bbsj
鸨	bbsn
壁	bbt_
堡	pbt_
瘢	bbv_
璧	bbw_
癍	bbww
惫	bbx_
憋	bbxl
瘭	bbxs
瘪	bbz_
龅	bcb_
螃	bcd_
蚌	bcf_
蝙	bch_
冫	bda_
褒	bdb_
卞	bdbd
疒	bdc_
灬	bdd_
宀	mdd_
殡	bdg_
禀	bdh_
裒	pdj_
亳	bdk_
夯	bdl_
殍	bdv_
把	beb_
扒	bebc
扮	feb_
抱	bebe
畚	bed_
詈	bedk
摆	bee_
排	pee_
拚	fee_
捕	bef_
拂	befg
搏	befn
捭	befs
扳	befy
摈	beg_
弁	begg
抨	peg_
拔	beh_
播	bei_
拍	pei_
拌	bej_
拼	pej_
撇	bejw
捌	bel_
拨	beo_
拊	ber_
摒	bes_
擗	pes_
罢	bet_
搬	bev_
拜	bfa_
爸	bfb_
泌	mfb_
濒	bfbe
飑	pfbe
渤	bfbl
辈	bfc_
汴	bfd_
掰	bff_
湃	bfff
溥	bffn
滨	bfg_
颁	bfh_
飚	bfhh
泊	bfi_
艴	bfib
潘	pfi_
费	bfk_
泼	bfo_
浜	bfq_
复	bfr_
瀑	pfr_
卑	bfs_
坌	bft_
灞	bfu_
滗	bfv_
蜚	pfv_
悲	bfx_
漂	pfx_
濞	bfz_
庇	bgb_
弼	bgbg
庀	bgbi
靶	bgbo
庳	bgf_
髀	bgfs
髌	bgg_
鞴	bgh_
魃	bghy
封	bgn_
宾	bgq_
鞭	bgr_
痹	bgt_
炳	bha_
秕	bhb_
秘	mhb_
髟	bhe_
彪	bhf_
稗	bhfs
煸	bhh_
布	bhj_
扁	bhk_
贲	fhk_
焙	bhl_
邦	bhp_
百	bhr_
爆	bhrs
稹	bhv_
虑	bhx_
秉	bia_
补	bib_
饱	bibe
袍	pib_
褙	bibn
八	bic_
裨	bif_
裱	bih_
褊	pih_
币	bij_
彭	pij_
饼	bijk
番	bim_
勹	bioo
白	bir_
褓	bird
饽	bis_
变	biy_
钵	bjb_
铋	ejb_
钯	bjbo
镑	bjd_
锛	bjdh
钣	bjf_
镔	bjg_
半	bjh_
钚	bjhb
钸	bjhj
钹	bjhy
铂	bji_
钡	bjk_
镳	bjl_
冰	bjs_
敝	bju_
镖	bjx_
吧	bkb_
吡	bkbb
叭	bkbc
卟	bkbd
哔	bkbs
哺	bkf_
啵	bkfp
匾	bkh_
唪	fkh_
呗	bkk_
鄙	bks_
嘣	bksp
芭	bl_
芘	blb_
苞	blbe
苯	blbh
耙	blbo
荜	blbs
办	bld_
苄	bldb
蒡	bldf
菝	ble_
薄	blf_
蒲	blff
彬	blfi
菠	blfp
萆	blfs
茇	blh_
蕃	bli_
蔽	blj_
瓿	blk_
别	bll_
剥	bllj
菩	pll_
葆	blr_
蓓	blrk
荸	bls_
薜	blsx
蓖	blx_
柄	bma_
粑	bmb_
枇	bmbb
杓	dmb_
杷	bmbo
榜	bmd_
枋	fmd_
标	bme_
板	bmf_
槟	bmg_
杯	bmh_
棒	bmhh
梆	bmhp
柏	bmi_
驳	bmii
募	bml_
闭	bmn_
骠	bmx_
妣	bnb_
膀	bnd_
膊	bnf_
婢	bnfs
脾	pnf_
膑	bng_
婊	bnh_
脖	bns_
膘	bnx_
媲	bnxb
嫖	pnx_
纰	bob_
纺	bod_
缤	bog_
绠	bogc
编	boh_
绑	bohp
匕	bio_
绊	boj_
绷	bon_
缏	bor_
陛	bpb_
阪	bpf_
陴	bpfs
剽	bpl_
瞥	bpm_
陂	bpo_
附	bpr_
甏	bpw_
狴	bqb_
狈	bqk_
飙	bqq_
仳	brbb
傍	brd_
俾	brf_
晡	brfd
佛	frf_
便	brg_
傧	brgb
暴	brgs
佰	brh_
俸	frh_
伯	bri_
伴	brj_
倍	brl_
曝	brr_
岜	bsb_
磅	bsd_
碑	bsf_
孛	bsg_
碥	bsh_
砭	bsi_
屏	bsj_
辟	bsk_
礴	bsl_
碚	bslk
崩	bsn_
泵	bss_
燹	bssh
豳	bsss
埠	btf_
埔	ptf_
埤	btfs
坂	btfy
畀	bti_
堋	btn_
鲍	bub_
雹	bube
卜	bud_
霸	bug_
鲅	buh_
鳊	buhl
鳔	bux_
逼	bva_
豹	bvb_
舭	bvbb
笨	bvbh
笆	bvbo
筚	bvbs
簿	bvf_
箔	bvfb
逋	bvfd
舨	bvfy
遍	bvh_
般	bvi_
舶	bvir
迸	bvj_
边	bvl_
笔	bvm_
簸	bvq_
避	bvs_
箅	bvt_
笾	bvv_
篦	bvx_
斌	bwa_
碧	bwb_
玢	fwb_
班	bwj_
玻	bwo_
斑	bww_
忭	bxd_
愎	bxf_
怫	bxfg
馥	fxf_
瓣	bxg_
怖	bxh_
窆	bxi_
怕	pxi_
辨	bxj_
蘖	bxn_
辫	bxo_
悖	bxs_
辩	bxy_
醭	bye_
孢	bzb_
趵	czb_
跸	bzbs
跋	bzh_
踣	bzl_
跛	bzo_
蹦	bzs_
瘛	cbf_
疮	cbr_
疹	cbrf
瘳	cbu_
龀	ccb_
蠢	ccc_
厨	ccd_
螭	ccdu
辰	cce_
蛇	ccg_
蝽	cch_
蟾	cci_
蝉	ccj_
唇	cck_
龊	cckr
厘	ccl_
剿	jcl_
氅	ccm_
盛	scm_
郢	ccp_
雏	ccr_
蜍	ccrm
辁	qcr_
辍	ccs_
徵	ccsw
徜	ccu_
龇	ccv_
蛏	ccy_
颤	cdh_
禅	cdj_
啻	cdk_
祝	cdke
鹑	cxn_
鸱	cdn_
辶	cdo_
豉	cds_
冁	cdso
离	cdx_
拆	cec_
捶	dec_
搐	ced_
掺	cee_
抬	tee_
搋	cef_
拖	tef_
捷	ceh_
亍	cej_
搓	gej_
掸	ceju
搽	cel_
搀	cem_
扭	ceo_
掾	ceos
插	ceq_
揄	uer_
抢	qer_
撮	cerq
揣	ces_
抻	ses_
撤	ceu_
撑	ceus
扯	cev_
耻	ceva
抄	cex_
抽	cey_
渐	cfc_
淳	cfd_
澶	cfdd
池	cfe_
治	ife_
沉	cfg_
沱	tfg_
涛	cfh_
滞	vfh_
沈	cfj_
潼	cfl_
澄	cfo_
涌	yfo_
滁	cfp_
湛	cfq_
重	cfr_
涂	tfr_
潺	cfs_
淑	sfs_
沌	cft_
岔	cfu_
浈	cfub
沾	dfu_
淌	tfu_
澈	cfuw
淖	nfu_
汊	cfy_
溴	cfz_
宸	cgc_
魑	cgd_
弛	cge_
宠	cgh_
宅	cgi_
瘥	cgj_
廛	cgl_
床	cgm_
黜	chc_
秤	chg_
称	chi_
稠	dhi_
炊	chir
舂	chj_
炽	chk_
春	chr_
乘	chu_
焯	vhu_
烛	vhv_
炒	chx_
移	ihx_
垂	cia_
初	cid_
饬	cif_
褫	cifh
饰	cifj
刍	cii_
喜	cij_
囱	cik_
裎	cikw
褚	cil_
馋	cim_
馇	vim_
衬	cin_
彳	cir_
裣	cirh
川	ciu_
衩	ciy_
舄	cjb_
锤	cjc_
钏	cjcu
斥	cjd_
铲	cjdc
铳	cjdy
镞	cjf_
镲	cjg_
帱	cjh_
净	cji_
幢	cjl_
钮	cjo_
锄	cjq_
锸	cjqj
铛	cju_
冲	cjv_
触	cjvh
铖	cjw_
钞	cjx_
镩	cjxc
镡	tjx_
钗	cjy_
呈	cka_
叱	ckb_
吃	ck_
嚓	ckg_
吹	cki_
噌	ckj_
唠	ckl_
喳	ckm_
啸	ckn_
嗤	cko_
唱	ckr_
呛	ckrp
嘬	vkr_
喘	cks_
嘲	cksn
啜	ckss
哧	ckt_
臣	cku_
屮	nku_
苫	tku_
嗔	ckv_
吵	ckx_
哆	dkx_
苌	clc_
茺	cld_
蔟	clf_
茬	clh_
莉	llh_
著	cll_
葱	cln_
楚	clo_
丞	cloa
莼	clot
郴	clp_
苴	clq_
茶	clr_
荼	elr_
菖	clrr
茌	clrs
荃	qlr_
芪	cls_
串	clu_
茧	clv_
茈	nlv_
蒇	clw_
耖	clx_
骊	cma_
橱	cmc_
棰	dmc_
枨	cmcc
盯	cmd_
驰	cme_
眙	ime_
杵	cmf_
檫	cmg_
柠	nmg_
椿	cmh_
瞅	cmhh
阐	cmj_
槎	cmjg
枕	cmjo
眈	dmj_
榇	cml_
楮	cmlr
闯	cmm_
楂	vmm_
橙	cmo_
椽	cmos
阊	cmr_
椎	vmr_
柢	cms_
骣	cmsz
瞠	cmu_
樗	cmuk
樘	tmu_
槌	cmv_
眵	cmx_
骋	cmy_
杈	cmyd
柽	cmyt
朐	cnb_
嬗	cnd_
膪	vnd_
肜	cnf_
姹	cng_
塍	cnj_
婵	cnju
柴	cnm_
肠	cno_
媸	cnoc
娼	cnr_
胝	cns_
胂	sns_
肫	cnt_
嫦	cnu_
妯	cny_
绌	coc_
绍	cod_
巢	cog_
缠	cogl
绸	coi_
绉	voi_
巛	coo_
缀	cos_
丑	cot_
绰	cou_
蚩	cov_
缜	vov_
陲	cpc_
陈	cpd_
氚	cqc_
猹	cqm_
猖	cqr_
愁	cqx_
晨	crc_
伥	crv_
俦	crh_
傺	cri_
仇	crj_
晁	vrj_
促	crk_
僮	crl_
仓	crp_
昌	crr_
伧	nrr_
倡	crrr
偿	cru_
倘	tru_
侪	crw_
晟	jrw_
侈	crx_
储	cry_
絮	xry_
土	csa_
匙	csb_
尺	csc_
砗	cscg
崭	vsc_
硫	csd_
碜	cse_
敞	csf_
敕	esf_
崇	csg_
嵊	csh_
斫	csj_
刹	csl_
碴	csm_
畅	cso_
羼	csy_
朝	csz_
孱	jsz_
坼	ctc_
赤	ctf_
畴	cth_
埕	ctk_
堪	ctq_
墀	cts_
坻	dts_
填	ctv_
城	ctw_
尝	cug_
裳	cugi
斜	cuj_
尚	cuk_
鲳	cur_
鲋	fur_
戳	cuv_
笞	cve_
篪	cvf_
簇	nvf_
舡	cvg_
筹	cvh_
虫	cvhd
逞	cvk_
觇	ivk_
踅	xvk_
艟	cvl_
盅	cvm_
豺	cvn_
齿	cvr_
迟	cvs_
遄	cvse
掣	cvsj
矗	cvv_
惩	cvx_
翅	cvxx
雠	cvy_
处	cwb_
琛	cwg_
虿	cwv_
怅	cxc_
怊	cxd_
鬯	cxdb
舛	cxh_
窗	cxi_
惆	dxi_
忏	qxi_
忱	cxj_
帘	lxj_
憧	cxl_
憷	cxlp
怵	cxm_
郗	cxp_
怆	cxr_
惴	cxs_
尘	cxt_
畜	cxth
惝	cxu_
忡	cxv_
谶	cyc_
诎	qyc_
叉	cyd_
醇	cydz
诧	cyg_
谄	cyi_
诌	cyii
酲	cyk_
酮	dyk_
诸	cyl_
醛	cylq
谗	cym_
谌	cyq_
昶	cyr_
醒	xyr_
酬	cyv_
蹰	czc_
臭	czd_
躔	czg_
踱	dzg_
踌	czh_
躇	czl_
趁	czr_
踹	czs_
踟	czsk
踔	czu_
趟	tzu_
至	da_
丁	daj_
豆	dak_
歹	dax_
痘	dba_
疔	dbd_
勺	sbd_
赕	dbh_
赡	dbi_
瘅	dbj_
赌	dbl_
瘩	dblh
疸	dbr_
癜	dbs_
癫	dbv_
轺	dcd_
轶	dci_
蚪	dcj_
粜	dcjm
德	dcs_
蝶	tcs_
待	dct_
蜒	dcv_
蜓	tcv_
丶	ddd_
殆	dde_
耷	vde_
顶	ddh_
祷	ddhn
袋	ddi_
凳	ddio
帝	ddj_
殚	ddju
敦	dxf_
剁	ddl_
夺	ddn_
鸫	ddna
郸	ddp_
邸	ddpu
堕	ddt_
岱	ddu_
黛	dduj
纛	ddux
怼	ddx_
憝	ddxl
打	ded_
抗	dedi
耵	dedj
掂	deg_
甙	degh
捣	dei_
投	tei_
抖	dej_
挑	tej_
耽	dejo
搭	del_
担	der_
聃	derh
抵	des_
揲	ees_
掇	dess
掉	deu_
挡	deui
拈	neu_
滴	dfd_
汀	dfdj
沲	dff_
渡	dfg_
淀	dfgr
淡	dfh_
澹	dfi_
洮	dfj_
洞	dfk_
盾	dfs_
渎	dfsm
渫	ifsm
滇	dfv_
涉	sfv_
涎	dfvv
涤	dfw_
爹	dfx_
潭	tfx_
髑	dge_
宕	dgh_
瓞	dgi_
弹	dgj_
度	dgn_
靼	dgr_
底	dgs_
骶	dgsd
店	dgu_
鞑	dgv_
灯	dhd_
煅	dhf_
蠹	dhg_
橐	lhg_
石	dhk_
毒	dhm_
黩	dhs_
炖	dht_
稻	dhv_
兜	dib_
詹	dic_
丹	did_
褡	dil_
朵	dim_
夂	dio_
裰	dis_
丢	dit_
裆	diu_
褶	viu_
亻	piu_
钓	djb_
冻	djd_
镝	djdg
钉	djdj
镦	djx_
锻	djf_
锭	djg_
镀	djgy
凋	dji_
铥	djiq
钭	djj_
铫	yjj_
锐	njj_
兑	djk_
铞	djkj
锗	djl_
杂	djm_
弟	djo_
镫	djod
锝	djr_
斗	djs_
钝	djt_
钿	djth
铤	djv_
奠	djy_
铎	djyh
咄	dkc_
叮	dkd_
叼	dkda
呔	dkdd
嘀	vkd_
叨	dkdi
嗲	dkf_
啶	dkg_
啖	dkh_
哚	dki_
啁	tki_
吊	dkj_
嗒	dkl_
噔	dko_
喋	dks_
冉	rks_
囤	dkt_
嘟	dkv_
哒	dkvd
咚	dkw_
耋	dla_
芍	dlb_
蒂	dld_
葶	tld_
荡	dlf_
菪	dlg_
蔸	dli_
萏	dlij
荻	dlq_
莜	dlr_
端	dls_
芏	dlt_
栋	dmd_
驮	dmdc
骀	dme_
椴	dmf_
柁	dmg_
檐	dmi_
睇	dmjo
觌	dmk_
桐	tmk_
睹	dml_
棣	dmll
鼎	dmo_
瞪	dmod
椟	dms_
杜	dmt_
盹	vmt_
妒	dnd_
胨	dndd
膻	sndd
嫡	dndg
腚	dng_
娣	dnj_
胴	dnk_
盗	dnm_
妲	dnr_
犊	dns_
豚	tns_
肚	dnt_
登	doa_
刁	doaa
约	dob_
缍	doc_
缔	dod_
绐	doe_
缎	dof_
刀	doi_
甬	dok_
隶	dos_
彖	tos_
卩	dou_
陀	dpg_
牒	dps_
牍	dpsm
陡	dpt_
阽	dpu_
蛋	dpv_
陟	vpv_
隋	dpz_
氘	dqf_
靛	dqg_
氮	dqh_
狄	tqh_
独	dqv_
氡	dqw_
旦	dra_
仃	drd_
代	dre_
俊	jre_
傣	drh_
儋	dri_
佚	iri_
倜	tri_
籴	drj_
佻	trj_
侗	drk_
但	drr_
低	drs_
佃	drt_
倒	drv_
短	dsa_
碲	dsdj
氐	dsd_
岽	dsdd
礅	dsx_
敌	dsf_
戴	dsg_
碇	dsgr
殿	dsgs
躲	dsi_
碉	dsik
焘	dsj_
峒	dsk_
硐	dskk
凼	dsku
砀	dso_
鸟	nso_
磴	dsod
嶝	dsod2
沓	dsr_
碓	dsrh
碟	dss_
砥	dssd
砘	dst_
碘	dsu_
巅	dsv_
垤	dta_
町	dtd_
墩	dtx_
坛	dte_
顿	dth_
烫	tth_
垛	dti_
埝	dtj_
垌	dtk_
堵	dtl_
塔	ttl_
埭	dtll
堆	dtr_
堤	wtr_
塌	dtru
堞	dtsm
坫	dtu_
怠	itx_
典	dub_
党	dug_
鲷	dui_
刂	duj_
翟	dur_
鳎	tur_
鲽	dus_
逗	dva_
达	dvd_
貂	dvdk
迨	dve_
竺	vve_
遁	dvf_
舵	dvg_
颠	dvh_
迭	dvi_
篼	dvie
追	vvi_
蜩	dvik
逯	dvis
点	dvj_
递	dvjo
箪	dvju
道	dvjz
筒	dvk_
逮	dvl_
笃	dvm_
第	dvo_
簦	dvod
簖	dvoj
都	dvp_
答	dvr_
笪	dvra
雕	dvrh
逾	uvr_
逐	dvs_
等	dvt_
垫	dvta
簟	dvx_
迪	dvy_
笛	dvyg
玎	dwd_
趸	dwk_
玳	dwr_
玷	dwu_
窒	dxa_
忉	dxd_
惦	dxg_
戥	dxgd
惮	dxj_
恫	dxk_
懂	dxl_
怛	dxr_
窬	dxrl
窦	dxs_
悼	dxu_
憾	dxx_
忑	txx_
惰	dxz_
订	dyd_
谛	dydj
酊	dydj2
诒	dye_
酡	dygb
动	dyl_
邓	dyp_
读	dys_
诋	dysd
羝	dysd2
谍	dysm
叠	dysq
谠	dyu_
诞	dyv_
蹄	dzd_
踮	dzgv
跺	dzi_
蹲	dzj_
蹬	dzo_
踢	dzr_
蹀	dzs_
蹈	dzv_
二	eaa_
兕	eae_
鬲	eak_
肄	ebs_
卅	eca_
轭	ecc_
耸	ece_
祟	ecex
螋	ecf_
厮	ecq_
靥	ecqm
蛳	ecu_
徙	ecv_
蛾	ecw_
怂	ecx_
氵	edd_
祀	ede_
祠	edo_
夜	edr_
衰	edu_
扼	eec_
搔	eecc
掖	eed_
叁	eede
参	ned_
揶	eee_
贰	eeeb
撰	vee_
搜	eef_
撒	eeh_
扫	eei_
搠	eej_
损	eek_
台	tek_
擞	eel_
鸶	een_
鸸	eena
耶	eep_
邺	qep_
撕	eeq_
拽	eeu_
搡	eey_
摁	eeyx
聂	ney_
液	efd_
泣	efda
洱	efe_
渗	lfe_
汜	efeo
飕	eff_
溲	sff_
渍	efh_
溯	efj_
泗	efk_
洇	yfk_
淞	efm_
濉	efmv
爷	efp_
澌	efq_
涩	efr_
涑	efs_
濡	efu_
洒	efx_
沙	sfx_
叟	efy_
塞	egh_
颂	eghb
寨	vgh_
宋	egm_
宿	egr_
髓	egv_
私	ehe_
耳	rhe_
肆	the_
穗	ehh_
烨	ehhs
页	ehk_
散	ehn_
燥	ehp_
穑	eht_
燧	ehv_
夙	eia_
饵	eie_
饴	iie_
馊	eif_
馓	eih_
彡	eii_
儿	eio_
饲	eiok
馀	eir_
饿	eiw_
尔	eix_
冶	eje_
铒	kje_
锼	ejf_
铯	eji_
铩	sji_
锷	ejk_
凇	ejm_
觫	ejs_
锶	ejt_
锇	ejw_
铘	ejy_
哑	eka_
邑	ekb_
啐	ekd_
唆	eke_
咝	ekea
嗖	ekf_
嗾	ekfs
噻	ekg_
嗉	ekh_
嗍	ekj_
鄂	ekkp
咽	ekkd
嗣	ekk_
颚	ekke
鹗	ekkn
嘶	ekq_
喝	ekr_
叶	eks_
噎	eksd
嗦	eksm
嗽	eksq
唢	eku_
哨	sku_
虽	ekv_
哦	ekw_
唔	ekwk
嗓	eky_
嗯	nky_
苊	elc_
蓑	eld_
莎	elf_
飒	eli_
蔡	nli_
蒴	elj_
荪	elz_
萼	elk_
薮	ell_
菘	elm_
菥	xlm_
耜	elo_
萨	elp_
蒜	els_
竦	elsc
蔌	elsq
蔷	elt_
野	elu_
荽	elv_
莪	elw_
蒽	ely_
骚	emc_
粹	emd_
梭	eme_
糁	sme_
椰	emep
睃	emew
阏	emf_
桫	emfx
瞍	emfy
析	emj_
驷	emk_
森	emm_
睢	emr_
眭	emt_
梢	emu_
榫	emv_
槭	emw_
腋	end_
嫂	enf_
脎	eni_
腭	enk_
毵	enm_
姒	eno_
婀	enp_
臊	enpm
腮	ent_
娥	enw_
牺	enx_
司	eo_
巳	eoao
厶	eod_
缩	eog_
丝	eoo_
纟	poo_
缫	eoog
缲	eop_
缌	eot_
绥	eov_
隧	epv_
狻	eqe_
狲	eqj_
仨	era_
俗	erb_
曷	erbo
食	erd_
侉	erdk
俟	ere_
佴	ereh
晔	erh_
伞	erj_
僧	erjr
伪	erl_
似	ero_
曳	eroi
伺	nro_
僳	erx_
碎	esd_
嵩	esdk
索	esg_
颡	esh_
崧	esm_
槊	esmc
娑	esn_
射	isn_
屙	esq_
雉	esr_
挲	ess_
尿	nss_
塑	est_
峨	esw_
硪	isw_
磉	esy_
垭	eta_
丧	etd_
啬	etdh
诶	ete_
埽	eti_
寺	etn_
鳋	euc_
鲕	euh_
霰	xuh_
稣	eui_
鳄	euk_
霍	eur_
鳃	eut_
逡	eve_
艘	evf_
迩	evi_
送	evj_
遂	evjs
算	evm_
笥	evo_
遏	evr_
簌	evs_
隼	evsg
遗	evv_
邃	evx_
笋	evy_
珥	ewe_
噩	ewk_
琐	ewu_
瑟	eww_
忪	exb_
愫	exh_
愕	exk_
飧	exr_
悚	exs_
讼	eyb_
谇	eyd_
酸	eye_
羧	eyew
酥	eyi_
谔	eyk_
诵	eyo_
邪	eyp_
谒	eyr_
讹	eyrb
桑	eys_
垩	eyt_
墅	eet_
谡	eytw
恩	eyx_
糸	eyxd
恶	wyx_
跣	ezi_
甫	fak_
匚	fao_
赋	fba_
匐	fbat
痱	fbe_
贩	fbf_
赙	fbfn
父	fbi_
疯	fbii
否	fbk_
辐	fca_
蝠	fcat
彷	fcd_
蝮	fcf_
蚨	fcfc
蟠	fci_
蜉	fcv_
蜂	fcw_
福	fd_
祓	fdh_
喷	pdh_
奋	fdt_
扶	fef_
罘	feh_
捧	peh_
黻	fej_
黼	fejf
掊	fel_
夫	fer_
丰	feu_
抚	few_
罚	fey_
汾	ffb_
斐	ffd_
裴	pfd_
放	fff_
沸	fffg
沣	fffg2
滏	fffi
敷	fffw
泛	ffi_
攵	ffic
斧	ffj_
涪	ffl_
瀵	ffm_
淝	ffn_
邡	ffp_
郛	fvj_
阜	ffs_
垡	fft_
浮	ffv_
釜	ffw_
翻	ffx_
忿	ffxl
翡	ffxx
反	ffy_
富	fga_
宓	fgb_
腐	fgf_
弗	fgfg
废	fgo_
扉	fhe_
奉	fhh_
烦	fhhb
燔	fhi_
雇	fhr_
稃	fhv_
烽	fhw_
麸	fhwf
凡	fid_
饭	fif_
凫	fii_
袢	fij_
犭	qij_
负	fik_
袱	fir_
乏	fiv_
凤	fiy_
钫	fjd_
幞	fje_
镄	fjf_
帆	fji_
钒	fjid
幡	fjit
锫	fjl_
冯	fjm_
锋	fjw_
吩	fkb_
吠	fkd_
匪	fke_
呋	fkf_
咐	fkr_
呒	fkw_
芬	flb_
棼	flbd
芳	fld_
菲	fle_
藩	flf_
芙	flfc
莆	flfd
葑	flg_
焚	flh_
芾	flhg
梵	fli_
蘩	flm_
菔	fln_
茯	flr_
苻	plr_
孵	flv_
莩	flvz
粉	fmb_
盼	fmbd
粪	fmh_
枫	fmi_
榧	fmk_
阀	fmr_
驸	fmrn
桴	fmv_
愍	fmw_
樊	fmy_
肥	fnb_
妨	fnd_
肪	fndw
腓	fne_
腹	fnf_
肤	lnf_
脯	fnfd
腑	fng_
肺	fnh_
妃	fni_
妇	fno_
纷	fob_
绯	foe_
缚	fof_
绋	fofg
绂	foh_
阝	fou_
缝	fov_
鹏	fpn_
氛	fqb_
氟	fqf_
狒	fqfg
仿	frd_
伏	frdd
傅	frfn
伐	frg_
俯	frgf
偾	frhb
付	frn_
俘	frv_
仅	fry_
鼢	fsb_
酆	fsf_
砩	fsfg
矾	fsi_
砜	fsii
砝	fst_
坟	ftd_
畈	ftf_
鲂	fud_
鲱	fue_
鳆	fuf_
鲼	fuh_
舫	fvd_
返	fvf_
篚	fvk_
筏	fvr_
逢	fvw_
逄	pvw_
孚	fvz_
缶	fwk_
悱	fxe_
愤	fxh_
酚	fyb_
讣	fybd
诽	fye_
讽	fyi_
趺	fzf_
蹯	fzi_
跗	fzr_
廾	gai_
戈	gao_
更	gar_
亘	xar_
丐	gau_
购	gbb_
皋	gbd_
赅	gbdr
勾	gbe_
疙	gbf_
皈	gbfy
疳	gbg_
痕	hbg_
痼	gbk_
谷	gbr_
蚣	gcb_
虼	gcf_
蜾	gcg_
虹	hcg_
蜮	ucg_
蝈	gck_
咎	jck_
蛊	gcm_
轧	gco_
辊	gcr_
蛤	gcrk
轱	gcs_
蛄	gcsk
裹	gdg_
亢	gdi_
祈	gdj_
膏	gdk_
郭	gxp_
罡	gea_
拘	geb_
扩	ged_
扛	geg_
顾	geh_
拱	ueh_
耿	gehc
拐	gek_
掴	geku
搁	gem_
掼	geo_
聒	geq_
括	keq_
捍	ger_
擀	ges_
罟	gesk
挂	get_
汗	gfa_
沟	gfb_
夹	gfd_
鬼	gfe_
汽	gff_
港	gfg_
缸	gfga
浑	gfgc
泔	gfgh
涫	gfgo
搿	gfh_
潢	gfhb
浩	gfi_
滑	gfk_
涡	wfk_
滚	gfli
沩	wfl_
灌	gfl_
罐	gflv
溉	gfo_
澉	hfo_
活	gfq_
淦	gfr_
混	hfr_
沦	lfrb
汩	gfrh
沽	gfs_
盥	gfsm
洼	gft_
卦	ggb_
骸	ggd_
故	ggf_
攻	ggfi
髂	ggg_
寡	ggh_
鞲	gghr
歌	ggi_
巩	ggid
骰	tgi_
羹	ggj_
宄	ggji
贡	ggk_
宫	ggkk
刚	ggl_
剐	gglj
划	hgl_
辜	ggls
瞽	ggm_
鹄	ggn_
鸪	ggna
鹘	hgna
官	ggo_
赓	ggob
庚	ggoc
嘏	ggoy
郜	ggp_
汞	ggs_
庋	ggsy
蛩	ggv_
骼	ggw_
恭	ggx_
戆	vgx_
冠	ggy_
秆	gha_
稿	ghd_
颌	ghh_
割	ghl_
刽	ghlj
鸽	ghn_
炔	gho_
觏	ghr_
睾	gie_
馆	gig_
褂	gigb
瓜	gii_
角	jii_
鼓	gij_
告	git_
龟	giu_
袼	giw_
镉	gja_
钩	gjb_
镐	gjd_
哿	gjdk
钙	gjg_
觚	gjgc
锞	kjgc
孤	gzgc
锆	gji_
钾	gjj_
钢	gjk_
锢	gjkg
锅	gjkn
帼	gjku
鸲	gjn_
钆	gjo_
觖	kjo_
尬	gjr_
锟	kjr_
旮	gjrh
铪	jjr_
钴	gjs_
尴	gju_
觥	gjuw
盖	gjw_
羔	gjwj
铬	gjwk
嗝	gka_
囗	pka_
匦	gkc_
哥	gkd_
咳	kkd_
哌	gkf_
呱	gkg_
哽	gkgc
瓠	hkg_
哏	gkgl
嘎	gkh_
颃	gkhb
唬	gkhi
冈	gki_
呷	gkj_
噶	gkl_
咖	kkl_
呙	gkn_
骨	gko_
邢	gkp_
哙	gkr_
咕	gksk
哇	gkt_
咣	gku_
匮	gkv_
咯	gkw_
苟	glb_
蒿	gld_
衮	gle_
菏	glf_
苷	glg_
茛	glgl
藁	glgm
菅	jlg_
莞	wlg_
龚	glh_
耕	glj_
菰	glz_
鹳	glk_
菇	gln_
葛	glr_
芥	glrf
苦	gls_
杆	gma_
构	gmb_
枸	gmbk
槔	gmbs
椁	gmd_
槁	gmdk
根	gmg_
杠	gmga
梗	gmgc
柑	qmg_
棺	gmgo
横	gmh_
梏	gmi_
桅	wmi_
糕	gmj_
闸	vmj_
柜	gmk_
概	gmo_
橄	gmow
栝	gmq_
矜	gmrj
桧	hmr_
枯	gms_
桂	gmt_
闺	gmtt
桄	gmu_
阁	gmw_
肝	gna_
膈	gnah
奸	jna_
胲	hnd_
肛	gng_
胍	gngc
媾	gnh_
肱	gnhe
股	gni_
牿	gnik
臌	gniv
妫	gnl_
姑	gns_
牯	gnsk
娃	gnt_
胱	gnu_
胳	gnw_
尕	gnx_
戤	gny_
弓	goa_
癸	goad
缟	god_
敢	goe_
纥	gof_
绀	gog_
颈	goge
贯	gok_
纲	goki
艮	goo_
缑	gor_
绲	gorb
纶	lor_
绘	hor_
陔	gpd_
犷	gqd_
猓	gqg_
舌	gqk_
乖	gqu_
旰	gra_
合	hra_
佝	grb_
晷	grc_
伉	grd_
介	grf_
傀	krf_
仡	irf_
倌	grg_
供	grh_
炅	grhc
伽	grl_
果	gr_
杲	grm_
估	grs_
矸	gsa_
岣	gsb_
崞	gsd_
屹	gsf_
躬	gsg_
馘	gsga
硬	ysg_
彀	gsgs
毂	gsj_
岗	gsk_
崮	gskg
刮	gsl_
磙	gsli
刿	gslj
鸹	gsn_
硅	gst_
硌	gsw_
乾	gsz_
斡	wsz_
塥	gta_
垓	gtd_
垢	gtf_
圪	itf_
埂	gtg_
坩	gtgh
埚	gtk_
鳜	guc_
鳏	gue_
鲠	gug_
归	gui_
鲧	guim
鲴	guk_
鲑	gut_
丨	guu_
够	gux_
贵	gva_
竿	gvas
笱	gvb_
舸	gvd_
篙	gvdk
箍	gve_
管	gvg_
筻	gvgc
簋	gvgm
篝	gvh_
遘	gvhr
虢	gvn_
逛	gvq_
赣	gvw_
瑰	gwf_
珙	gwh_
蠃	gwk_
尜	gxd_
贾	gxk_
惯	gxo_
恍	gxu_
怪	gxy_
酐	gya_
该	gyd_
诟	gyf_
诡	gyi_
诰	gyik
诂	gys_
酤	gysk
诖	gyt_
蹶	gzc_
跟	gzg_
跪	gzi_
韦	haa_
翮	hak_
互	hao_
鼾	hba_
訇	hbd_
鬟	hbe_
皖	wbg_
贿	hbh_
癀	hbhb
痪	hbi_
皓	hbik
瘊	hbr_
虾	hca_
轩	hcas
蝗	hcb_
徨	hcbw
蚵	hcd_
蚶	hcgh
辖	xcg_
蝴	hcgn
蟥	hch_
蟪	hchx
衡	hci_
轷	hcih
徊	hck_
蛔	hckk
蠖	hcl_
蚝	hcm_
郝	hcp_
厚	hcr_
蝎	hcro
徽	hcs_
赫	hct_
辂	hcw_
患	hcx_
轰	hcy_
後	hcyw
唤	hdi_
毫	hdk_
亨	pdk_
祸	hdkn
豪	hdks
亥	hdo_
火	hdr_
祜	hds_
哕	nds_
擐	hee_
挥	heg_
找	veg_
换	hei_
掀	hej_
捆	hek_
撖	heo_
揭	jer_
攉	heu_
援	hev_
撼	hex_
洹	hfad
汪	wfa_
湟	hfb_
漶	hfc_
河	hfd_
沆	kfd_
沪	hfds
濠	hfds2
海	hff_
彗	hffi
鸿	hfg_
泓	hfge
浣	hfgy
洪	hfh_
滹	hfhh
砉	hfhk
涣	hfiu
灏	hfj_
汇	hfk_
涸	hfkg
洄	hfkk
溷	hfks
涵	hfl_
淮	hfrh
洽	qfr_
渴	jfr_
浍	hfry
瀚	hfs_
溃	hfv_
汉	hfy_
滩	nfy_
浒	xfy_
罕	hgb_
弘	hge_
寰	hgei
巷	xge_
害	hgf_
骺	hgfk
辉	hgg_
弧	hggc
宏	hgh_
寒	hghj
湖	hgn_
胡	hgnh
邯	hgp_
邗	hgpu
宦	hgu_
憨	hgx_
恚	hgxl
夥	hgxx
煌	hhb_
豁	hhbk
炕	hhd_
煳	hhg_
稞	khg_
灰	hhh_
烘	hhhb
颔	hhhb2
颏	khhb
虎	hhi_
烀	hhih
焕	hhiu
戽	hhj_
焓	hhjk
货	hhk_
扈	hhkb
劾	hhl_
鹕	hhn_
焊	hhr_
烩	hhry
华	hhs_
秽	hhsx
惑	hhxl
慧	hhx_
黄	hhy_
凰	hib_
禾	him_
褐	hir_
奂	hiu_
鹤	hjd_
豢	hjf_
毁	hjg_
黉	hjgh
鲎	hjgu
铧	hjh_
冱	hjha
颢	hjhb
钬	hjhc
斛	hjj_
贺	hjk_
镬	hjl_
幌	hjr_
钤	hjrj
锾	hjv_
锪	hjw_
吓	hka_
嗥	hkb_
吭	hkdi
哼	hkdl
嚎	hkds
圜	hke_
嗨	hkf_
号	hkh_
哄	hkhb
咴	hkhh
哗	hkhs
呼	hki_
吼	hkj_
嗬	hkl_
嚆	hklg
喙	hko_
嗑	hkq_
哈	hkr_
喉	hkrs
喟	kkt_
嘿	hku_
嚯	hkuv
喊	hkw_
囫	hkwi
唿	hkwx
芴	hlb_
蘅	hlc_
苛	kld_
芒	mld_
芦	hlds
薨	hle_
茫	mlf_
葫	hlg_
荤	hlgc
蕙	hlh_
蕻	hlhg
函	hlj_
茴	hlk_
菡	hll_
耗	hlm_
薅	hln_
荭	hlo_
获	hlq_
荷	hlr_
萑	hlrh
耠	hlrk
荟	hlry
藿	hlu_
劐	hlv_
荒	hlw_
桓	hma_
桁	hmc_
杭	hmd_
骇	hmdr
眩	jmd_
槐	hmf_
糊	hmg_
闳	hmhe
骅	hmh_
桦	hmhs
槲	hmj_
阋	hmje
麾	hmm_
阚	hmo_
阖	hmq_
糇	hmrs
阍	hms_
脘	hng_
鹱	hnl_
妞	hno_
婚	hns_
缴	hob_
绗	hoc_
缳	hoe_
缗	hom_
馄	kor_
缓	hov_
缋	hovb
氦	hqd_
狼	lqd_
狐	hqg_
猢	hqgn
獬	hqj_
猾	hqk_
獾	hql_
盍	hqm_
猴	hqr_
昊	hrad
旱	hras
化	hr_
何	hrd_
晦	hrf_
晖	hrg_
伙	hrh_
晗	hrj_
侯	hro_
候	hru_
晃	hruw
卉	hsg_
壶	hsge
嵌	qsg_
觳	hsgs
磺	hsh_
昏	hsr_
隳	hsrd
岵	hss_
翰	hsz_
壕	htd_
垸	htg_
坯	htp_
堠	htr_
鳇	hub_
壑	hug_
鲩	hugy
虍	huq_
遑	hvb_
篁	hvbw
航	hvd_
逅	hvf_
逭	hvg_
簧	hvh_
篌	hvr_
貉	hvw_
笏	wvw_
珩	hwc_
珲	hwg_
瑚	hwgn
璜	hwh_
琥	hwhi
肓	hwn_
虺	hwv_
瑗	hwvy
忽	hwx_
恒	hxa_
惶	hxb_
悔	hxf_
恨	hxg_
恢	hxh_
慌	hxl_
羽	hxo_
郇	hxp_
悍	hxr_
怙	hxs_
惚	hxw_
诃	hyd_
魂	hyf_
诲	hyfm
酣	hyg_
讧	hyga
诨	hygc
戏	xyg_
醐	hygn
诙	hyh_
欢	hyi_
谎	hyl_
幻	hyo_
讳	hyw_
醢	hyy_
踝	hzg_
丌	iai_
弋	iao_
贻	ibe_
疫	ibi_
痍	ibic
瘵	vbi_
瘠	ibj_
瘗	ibjt
劓	ibl_
疑	ibs_
髻	ibsk
冀	ibt_
疵	ibv_
癔	iby_
蚁	icd_
蜡	ich_
厝	nch_
役	ici_
虮	icio
辑	ick_
蜴	icr_
亦	idf_
衣	idi_
殛	idl_
衤	ido_
殪	ids_
掎	ied_
矣	ief_
异	ieg_
羁	iegm
抑	iei_
揖	iek_
挹	iekb
挤	iew_
择	iey_
激	if_
旖	iff_
汲	ifi_
洎	ifim
洫	xfim
溢	ifj_
沂	ifju
漪	ifq_
洁	ifs_
泄	xfs_
寄	igd_
寂	igs_
棘	ihh_
焱	ihhh
击	ihk_
墼	ihkt
秸	ihs_
稷	iht_
熠	ihu_
黟	ihxx
稽	ihy_
黝	ihyl
嵇	ihys
季	ihz_
奕	iid_
失	iif_
弈	iig_
饥	iii_
丿	pii_
裔	iik_
刈	iil_
释	iim_
脔	iimr
懿	iin_
夕	uio_
袂	mio_
印	iip_
暨	iir_
翳	iis_
忌	iix_
系	iiy_
铱	ijd_
铊	ijg_
钇	iji_
镒	ijj_
脊	ijr_
羡	ijw_
镱	ijy_
戢	ikg_
叽	iki_
咦	ikic
听	ikj_
呓	ikl_
唧	iko_
咿	ikr_
咭	iks_
颐	iku_
熙	xku_
哜	ikw_
叹	tky_
蒺	ilb_
蕲	ild_
毅	ilf_
萁	ilh_
麂	ilio
芨	ili_
荑	ilic
亟	ilk_
蕺	ilku
藉	ill_
苡	ilo_
芰	ils_
蓟	ilu_
荠	ilw_
翊	ilx_
薏	ily_
骥	imb_
椅	imd_
骑	qmd_
棋	imh_
极	imi_
楫	imk_
瞿	imm_
睽	imo_
驿	imy_
嫉	inb_
犄	ind_
姨	ini_
胰	inic
粢	inj_
姬	ink_
妓	ins_
臆	iny_
已	ioa_
绮	iod_
祭	ioe_
彐	poe_
绩	ioh_
级	io_
纪	ioi_
既	ioio
缢	ioj_
缉	iok_
彝	iom_
继	ioo_
乙	iooo
即	iop_
几	iio_
绁	ioso
绎	ioy_
猗	iqd_
欹	iqi_
剂	iql_
剞	iqlj
易	irb_
佾	irbn
依	ird_
仪	irdi
倚	irdk
佗	irg_
偈	irr_
伎	irs_
佶	irsk
嶷	isb_
屐	isc_
崎	isd_
壹	isg_
矶	isi_
岌	isic
觊	isij
嵴	isj_
尾	ism_
赍	isr_
居	iss_
峄	isy_
戟	isz_
畸	itd_
圯	ite_
坨	itg_
埸	itr_
翌	iud_
羿	iug_
鲫	iuo_
霁	iuw_
鲚	iuwf
笄	iva_
迹	ivd_
舣	ivdi
迤	ivf_
箕	ivh_
焉	yvh_
逸	ivi_
笈	ivic
籍	ivl_
乩	ivo_
郅	ivp_
齐	iwf_
齑	iwi_
怡	ixe_
悸	ixh_
悒	ixk_
怿	ixy_
讦	iya_
诣	iyb_
议	iyd_
酏	iyeo
谊	iyg_
讥	iyi_
谥	iyj_
鸡	iyn_
计	iys_
诘	jys_
意	iyx_
伊	iyy_
译	iyyh
畿	iyyt
跽	izi_
赆	jbc_
髫	tbd_
敫	jbf_
鬏	jbh_
贱	jbj_
匀	ybj_
疚	jbjc
皎	jbl_
痂	jblk
痉	jbo_
瘕	xbo_
疖	jbp_
疥	jbr_
徼	jcb_
蛱	jcf_
街	jcg_
蜻	jch_
尽	jcj_
蜷	qcj_
厥	jcjq
蝤	jcjy
蛟	jcli
径	jco_
厩	jcoj
卺	jcp_
蠼	jcq_
蚧	jcr_
蛙	jct_
轿	jcy_
豇	jdg_
歼	jdi_
牮	jdn_
揩	jeb_
撅	jec_
井	jef_
挟	xef_
拣	jehd
揪	jehh
搅	jej_
搛	jejh
押	yej_
攫	jejy
捐	jek_
抉	jeo_
戋	jeod
捡	jerh
拾	ser_
掘	jes_
拮	jesk
挢	jey_
捃	jeyk
韭	jfa_
溅	jfb_
契	qfd_
挈	jfds
恝	jfdx
泫	xfd_
浚	jfe_
旌	jff_
浃	jffi
湫	jfhh
钅	jfho
浸	jfi_
湔	jfj_
浅	qfj_
涓	jfk_
涧	jfm_
泾	jfo_
津	jfu_
滥	lfu_
洚	jfw_
酒	jfy_
穴	jgb_
军	jg_
敬	jgf_
戒	jgg_
謇	jgh_
骞	jghm
蹇	jghz
靳	jgj_
鞯	jgl_
廑	jgn_
弪	jgo_
骱	jgr_
疆	jgt_
鞒	jgy_
烬	jhc_
稼	jhg_
炯	jhk_
扃	jhkk
戛	jhm_
夏	xhm_
青	jhn_
烃	jho_
爝	jhv_
蠲	jie_
颉	jih_
斤	jiiu
嘉	jij_
饯	jijd
身	jik_
襟	jil_
饺	jili
裥	jim_
馑	jin_
袷	jir_
衿	jirj
臼	jiu_
锦	jjb_
锴	kjb_
钧	jjbj
镢	jjc_
解	jjd_
袈	jjdi
警	jjdk
卷	jjf_
铗	jjfi
眷	jjfm
桊	qjfm
觉	jjg_
戬	jjgd
镓	jjgs
灸	jjhc
颊	jjhb
锓	jjiy
钱	jjjd
锩	jjjp
觐	jjk_
镜	jjl_
铰	jjli
劂	jjlj
架	jjm_
驾	jjma
檠	qjm_
锏	jjmr
鸠	jjn_
鹫	jjna
鹪	jjna2
鹣	qjna
决	jjo_
兼	jjh_
皲	jjoy
郊	jjp_
郡	jjpu
郏	jjpu2
舅	jjt_
键	jjv_
镌	jjvn
减	jjw_
姜	jjwn
将	jjx_
奖	jjxd
桨	jjxm
浆	jjxs
酱	jjxy
矍	jjy_
喈	jkb_
噘	jkc_
兢	jkg_
啾	jkh_
噱	jkhs
匠	jkj_
嗟	jkjg
圈	qkj_
噤	jkl_
咬	ykl_
鹃	jkn_
叫	jko_
吟	jkr_
巾	jku_
嚼	jkv_
噍	jkvj
囝	jkz_
孑	jla_
蕨	jlc_
孓	jlcc
荩	jlcj
禁	jle_
竣	jlew
荚	jlf_
茳	jlfg
荐	jlhz
靖	jlh_
菁	jlhn
耩	jlhr
交	jli_
麇	jlim
蒋	jlj_
蒹	jljh
艽	jljo
竞	jlk_
菌	jlkh
荆	jlkl
茭	jlli
茄	qll_
茎	jlo_
葭	xlo_
节	jlp_
竟	jlr_
竭	jlro
蕞	zlr_
菽	jls_
蕉	jlvj
蕊	jlx_
楷	jmb_
橛	jmc_
骏	jme_
嫁	jmg_
粳	jmgc
糨	jmgs
精	jmh_
睛	jmhn
睫	jmhr
桷	jmi_
阄	jmiu
杰	jmj_
柙	jmjg
桕	jmjh
阙	qmj_
柩	jmk_
枧	jmke
枷	jml_
校	qml_
槿	jmn_
阕	qmo_
检	jmr_
睑	jmrh
椒	jms_
槛	jmu_
毽	jmv_
楗	jmvu
骆	jmw_
骄	jmy_
腈	jnh_
婧	jnhn
婕	qnh_
妖	jni_
肼	jnj_
娟	jnk_
胶	jnl_
姣	jnli
肋	lnli
胫	jno_
脚	jnq_
姐	unq_
妗	jnr_
堇	jnu_
腱	jnv_
犍	jnvu
娇	jny_
缰	joa_
廴	joc_
劲	jog_
刭	jogl
九	jio_
绝	joib
纤	qoi_
缣	joj_
绢	jok_
绞	jol_
纠	joo_
缪	mou_
绛	jow_
缄	jowk
缙	joy_
阱	jpj_
陉	jpo_
阶	jpr_
险	xpr_
獗	jqc_
剪	jqd_
静	jqi_
煎	jqj_
靓	jqk_
狷	jqkn
劫	jql_
獍	jqle
狡	xql_
犟	jqn_
却	jqp_
翦	jqx_
僵	jra_
景	jrd_
儆	jrg_
借	jrh_
剑	jrhl
僭	jrhr
侥	jrhw
今	jrj_
倦	jrjp
僦	jrjy
佼	jrl_
件	jrn_
假	jro_
暇	xro_
价	jrr_
俭	jrrh
晶	jrrr
倔	jrs_
佳	jrt_
甲	jru_
健	jrv_
僬	jrvj
侨	qry_
礓	jsa_
屈	jsc_
峻	jse_
截	jsg_
岬	jsj_
碣	jsr_
硷	jsrh
崛	jss_
礁	jsv_
碱	jsw_
矫	jsy_
峤	jsyf
均	jtb_
垧	sti_
境	jtl_
鲸	jud_
鲛	jul_
监	jum_
冂	juo_
旧	jur_
鉴	juri
鲒	jus_
鲣	juu_
紧	juy_
爵	jve_
箐	jvh_
笺	jvjd
胛	jvjg
焦	jvj_
箭	jvjl
近	jvju
舰	jvk_
笕	jvke
迥	jvkk
迦	jvl_
笳	jvlk
简	jvm_
筋	jvn_
隽	jvni
迳	jvo_
筠	jvt_
堑	qvt_
建	jvu_
箴	jvw_
玖	jwi_
珈	jwl_
珏	jww_
惊	jxd_
尖	jxdc
桀	jxh_
窖	jxi_
究	jxj_
憬	jxr_
鄄	jxt_
甄	vxt_
窘	jxy_
乔	jyf_
艰	jyg_
诫	jygg
谮	jyh_
谏	jyj_
君	jyk_
酵	jyl_
谲	jym_
谨	jyn_
诀	jyo_
谫	jyq_
晋	jyr_
羯	jyro
醮	jyv_
趼	jza_
蹴	jzj_
跤	jzl_
跏	jzlk
赳	jzo_
踺	jzv_
髡	kba_
贶	kbk_
蝰	kcd_
龈	kcg_
蝌	kch_
蛞	kcq_
夼	kdc_
奎	kdt_
挎	kedk
扣	kek_
抠	oek_
拷	kel_
亏	keo_
揆	keot
聩	kev_
缺	kfo_
溘	kfq_
库	kgc_
廓	kgd_
靠	kge_
髋	kgg_
髁	kggc
颗	kgh_
魁	kgj_
康	kgll
刊	kgl_
宽	kglj
邝	kgp_
骷	kgs_
垦	kgt_
客	kgw_
恐	kgx_
恳	kgxl
寇	kgy_
龛	khh_
刻	khl_
烤	khlh
盔	khm_
郐	khp_
裉	kig_
馅	kii_
卵	kip_
馈	kiv_
夔	kja_
钪	kjd_
钶	kjdk
喾	kjg_
颀	kjh_
馗	kjj_
铐	kjl_
锎	kjm_
孔	kzo_
臾	ujr_
铠	kjs_
铿	kju_
匡	kka_
喹	kkdg
兄	kke_
喀	kkg_
哭	kkk_
哐	kkkw
刳	kklj
困	kkm_
叩	kkp_
咔	kks_
啃	kkv_
蒈	klb_
蔻	klg_
芤	klj_
葵	klo_
蒯	klp_
莶	klr_
莰	klt_
蒉	klv_
枉	kma_
柯	kmd_
闶	kmdi
棵	kmg_
骒	kmgc
糠	kmgl
框	kmk_
眍	kmki
阃	kmkm
眶	kmkw
栲	kml_
瞰	kmo_
瞌	kmq_
胯	knd_
犒	kndk
妪	knk_
胩	kns_
纩	kod_
缂	kon_
凵	kou_
氪	kqg_
狯	kqr_
旷	krd_
侃	krk_
暌	kro_
侩	krr_
佧	krs_
倥	krx_
卡	ksb_
矿	ksd_
岢	ksdk
壳	ksg_
戡	ksgd
凯	ksi_
砍	ksif
尻	ksj_
硎	kskl
勘	ksl_
磕	ksq_
岿	ksu_
崆	ksx_
忐	tsx_
坑	ktdi
圹	ktdc
垮	ktd_
坷	ktdk
垠	ktg_
坎	kti_
坤	kts_
堀	ktsc
垲	ktsi
筘	kve_
筐	kvk_
适	kvq_
逵	kvt_
篑	kvv_
筷	kvx_
箜	kvxg
琨	kwr_
愧	kxf_
忾	qxf_
窥	kxfj
空	kxg_
窠	kxgc
慷	kxgl
穹	kxgo
悃	kxk_
悝	kxl_
慨	kxo_
窟	kxs_
恺	kxsi
愦	kxv_
恪	kxw_
课	kyg_
顽	kyh_
酷	kyi_
诓	kyk_
诳	kyq_
醌	kyr_
圣	kyt_
跬	kzt_
踩	kzv_
丽	lak_
吏	laki
疬	lbc_
痢	lbh_
瘌	lbhl
瘤	lbi_
痨	lbl_
瘘	lbm_
鬣	lbo_
癃	lbp_
癞	lbs_
瘰	lbt_
赂	lbw_
疠	lbwi
蛎	lcc_
螂	lcd_
辘	lcg_
蠊	lcgj
蜊	lchl
龄	lcj_
蛉	lcjd
历	lcl_
辆	lcld
轹	lcy_
辚	lcm_
蝼	lcmn
轮	lcr_
螺	lct_
轳	lcu_
厉	lcw_
徕	lcwi
六	ldb_
啦	lde_
良	ldg_
唳	ldh_
禄	ldi_
亮	ldk_
奁	ldki
量	ldl_
列	ldlj
礼	ldo_
朗	ljn_
郎	ljp_
殓	ldr_
率	ldy_
拉	led_
掠	ledx
撩	ledx2
垒	lee_
拢	leh_
掳	lehl
捩	lehq
摅	seh_
聊	lei_
拦	leje
拎	lej_
聆	lejd
捞	lel_
搂	lem_
抡	ler_
罱	les_
撂	let_
摞	letm
揽	leu_
摺	leub
撸	leur
擂	leut
捋	lev_
罗	lex_
罹	lexv
沥	lfc_
浪	lfd_
洌	lfdl
漓	lfdu
潦	lfdx
旅	lff_
旒	lfff
游	yff_
濂	lfg_
漉	lfgb
滤	lfh_
泷	lfhb
溜	lfi_
滦	lfim
泖	lfip
渌	lfis
泠	lfj_
涝	lfl_
泺	lfy_
漤	lfln
泪	lfm_
澜	lfmj
淋	lfmm
泐	lfp_
澧	lfq_
梁	lfr_
粱	lfrm
潋	lfrw
漏	lfs_
濑	lfsf
漯	lft_
泸	lfus
涟	lfv_
洛	lfw_
涞	lfwi
浏	lfwl
溧	lfx_
潞	lfz_
廊	lgd_
庐	lgds
廪	lgds2
寮	lgdx
庞	lgh_
廉	lgj_
魉	lgl_
髅	lgm_
牢	lgn_
鹿	lgo_
雒	lgr_
廖	lgu_
寥	lguf
龙	lhb_
炉	lhd_
戾	lhdd
稂	lhdg
燎	lhdx
炼	lhh_
黎	lhi_
黧	lhih
熘	lhit
烂	lhj_
稆	lhk_
剌	lhl_
烁	shl_
虏	lhli
烙	lhw_
留	lid_
裸	lig_
灵	lih_
馏	lii_
栾	lim_
褛	limn
鸾	lin_
娈	linh
銮	lir_
录	lis_
挛	lisj
峦	liu_
褴	lium
裢	liv_
恋	lix_
孪	liz_
尥	ljb_
凉	ljd_
锍	ljdf
锒	ljdg
冽	ljdl
凛	ljds
镣	ljdx
锣	lje_
镰	ljg_
镏	lji_
铆	mji_
冷	ljj_
铃	ljjd
铝	ljk_
锂	ljl_
铑	ljlb
铄	sjl_
钌	ljlj
铹	ljll
镂	ljm_
镧	ljmj
凌	ljt_
镙	ljtm
镭	lju_
镥	ljur
链	ljv_
锊	ljvn
铼	ljw_
喱	lkc_
呖	lkcl
嘹	lkd_
咧	lkdj
啷	lkdp
嘞	lkg_
喇	lkh_
咙	lkhb
囹	lkj_
呤	lkjd
吕	lkk_
哩	lkl_
叻	lkli
喽	lkm_
啉	lkmm
囵	lkr_
噜	lku_
老	llb_
苈	llc_
裂	lld_
莨	lldg
蓠	lldu
聋	lle_
萝	llex
落	llf_
蒗	llfl
劳	llg_
麓	llgb
荦	llgn
颅	llhb
茏	llhb2
砻	llhk
藜	llhs
烈	llj_
苓	lljd
赉	llk_
励	lll_
荔	llll
耢	llll2
梨	llm_
麟	llmh
耧	llmn
蒌	ulm_
蔺	llmv
犁	llng
鹭	lln_
鹂	llna
鸬	llna2
鹩	llna3
婪	llnh
膂	llnh2
药	llo_
邻	llp_
郦	vlp_
莅	llr_
鎏	llri
蔹	llrw
垄	llt_
菱	lltw
蓝	llu_
蓼	lluf
蕾	llut
莲	llv_
莱	llw_
瓴	llwo
翎	llx_
枥	lmc_
粝	lmcw
类	lmd_
粒	lmda
粮	lmdg
阆	lmdg2
榔	lmdp
驴	lmds
檩	lmds2
椋	lmdx
楞	lme_
椤	lmex
栊	lmh_
柳	lmi_
棂	lmih
榴	lmit
骝	lmit2
料	lmj_
阑	lmjd
柃	lmjd2
栏	lmje
闾	lmk_
栎	lml_
栳	lmlb
楼	lmm_
瞵	lmmh
榈	lmml
娄	lmn_
楝	lms_
棱	lmt_
骡	lmtm
榄	lmu_
橹	lmur
氇	lmur2
栌	lmus
檑	lmut
睐	lmw_
粼	lmx_
李	lmz_
臁	lng_
腊	lnh_
胧	lnhb
脶	lnk_
姥	lnl_
娌	lnla
膦	lnm_
嫘	lnt_
胪	lnu_
绺	loc_
缭	lod_
缡	lodu
练	loh_
绿	loi_
缕	lom_
蠡	losc
绫	lot_
缧	lotm
缆	lou_
络	low_
陇	lph_
阴	lpn_
陋	lpo_
陵	lpt_
隆	lpw_
獠	lqdx
猡	lqe_
猁	lqh_
氯	lqi_
狸	lql_
俪	lra_
仑	lrb_
例	lrdl
僚	lrd_
晾	lrdx
倮	lrg_
敛	lrh_
俐	lrhl
令	lrj_
伶	lrjd
旯	lrji
赁	lrk_
侣	lrkk
俩	lrl_
俚	lrla
佬	lrlb
仂	lrli
偻	lrm_
伦	lrr_
儡	lrt_
傈	lrx_
履	lsc_
砺	lscw
砬	lsda
赖	lsi_
岚	lsii
碌	lsis
岭	lsj_
劣	lsl_
砾	lsy_
崂	lsll
屡	lsm_
磷	lsmh
嶙	lsmh2
嵝	lsmn
磊	lss_
耒	lsu_
崃	lsw_
坜	ltc_
垃	ltd_
塄	lte_
墚	ltf_
垅	lth_
垆	ltu_
埒	ltv_
累	lty_
鲡	lua_
雳	luc_
鳓	lug_
零	luj_
览	luk_
卤	luki
酃	lukp
鲤	lul_
霖	lum_
鳞	lumh
鳢	luq_
鲁	lur_
戮	lurg
鹨	lurn
卢	lus_
雷	lut_
鲮	lutw
鲈	luu_
鲢	luv_
霾	muv_
露	luz_
逦	lva_
篱	lvd_
笠	lvda
逻	lve_
箩	lvex
簏	lvg_
笼	lvh_
遛	lvi_
辽	lvl_
遴	lvm_
篓	uvm_
邋	lvo_
籁	lvs_
篮	lvu_
舻	lvus
篥	lvx_
璃	lwd_
琉	lwdf
琅	lwdg
珑	lwh_
玲	lwj_
吝	lwkh
羸	lwk_
理	lw_
刘	lwl_
琳	lwm_
斓	lwmj
琏	lwv_
珞	lww_
嫠	lwwn
璐	lwz_
懔	lxd_
愣	lxe_
怜	lxjd
栗	lxm_
窿	lxp_
懒	lxs_
谅	lyd_
羚	lyj_
诔	lyl_
谰	lym_
醴	lyq_
醪	lyu_
酹	lyv_
酪	lyw_
踉	lzd_
趔	lzdl
躏	lzl_
跞	lzy_
蹒	mzl_
躐	lzo_
灭	mah_
勿	mbf_
瘼	mbl_
虻	mcd_
蛑	mce_
蜱	mcf_
螟	mcg_
蟒	mclh
蟆	mcld
螨	mcll
蠓	mcl_
蠛	mcls
蜢	mcz_
殁	mdi_
祢	ndi_
咩	mdj_
袤	mdm_
冖	mdo_
亩	mdt_
描	mel_
抹	mem_
拇	memd
扪	memo
抿	memo2
牟	men_
汶	mfd_
旄	mff_
溟	mfg_
沔	mfh_
没	mfi_
浼	mfiu
渑	mfk_
满	mfl_
漠	mfld
漭	mflg
沫	mfm_
沐	mfmc
湎	mfmh
泯	mfmo
渺	mfms
湄	mfo_
漫	mfr_
汨	mfrh
弭	mge_
弥	mgi_
鞔	mgiu
寐	mgj_
寞	mgl_
麻	mgm_
冥	mgr_
幂	mgrj
魅	mgw_
庙	mgy_
穆	mhbf
默	mhd_
煤	mhg_
秣	mhm_
焖	mhmx
熳	mhr_
墨	mht_
麦	mhw_
秒	mhx_
么	mie_
毛	mieo
馍	mil_
袜	mim_
卯	mip_
馒	mir_
免	miu_
蛮	miv_
帕	pji_
镁	mjj_
锚	mjl_
镆	mjld
米	mjm_
钼	mjmh
钔	mjmo
镅	mjo_
帽	mjr_
幔	mjry
镘	mjry2
铭	mjx_
锰	mjz_
黾	mkd_
哞	mke_
嘛	mkg_
唛	mkh_
咪	mkj_
骂	mkk_
喵	mkl_
吗	mkm_
嘧	mkms
鸣	mkn_
呐	nkn_
皿	mku_
味	mkw_
蔑	mle_
瞢	mlem
甍	mlew
莓	mlfm
茆	mli_
麋	mlj_
颟	mll_
茅	mlm_
茉	mlmc
蘼	mlmf
苜	mlmh
耄	mlmo
苠	mlmo2
蘑	mlms
耱	mlms2
荬	mlo_
莽	mlq_
莫	mlr_
萌	mlrn
蔓	mlry
苗	mlt_
藐	mlv_
茂	mlw_
梦	mlx_
茗	mlxk
棉	mmb_
蟊	mmc_
闵	mmd_
靡	mme_
眸	mmen
毪	mmen2
梅	mmfm
魔	mmfe
敏	mmf_
枚	mmfi
敉	mmfi2
瞑	mmg_
磨	mmh_
眄	mmho
麽	mmi_
鳘	mmia
幕	mmj_
眯	mmjm
糜	mmjm2
勉	mmli
勐	mmli2
勖	xmli
瞒	mmll
檬	mmls
瞄	mmlt
盟	mmm_
蓦	mmma
杩	mmma2
眠	mmmo
鹋	mmn_
鹛	mmna
楣	mmo_
暮	mmr_
摩	mms_
摹	mmsj
墓	mmt_
睦	mmtt
密	mmu_
闽	mmv_
蜜	mmvh
蝥	mmw_
鍪	mmwj
瞀	mmwm
婺	mmwn
慕	mmxd
杪	mmxi
眇	mmxi2
闷	mmx_
懋	mmxl
懑	mmxl2
縻	mmy_
媒	mng_
娩	mni_
脒	mnj_
膜	mnl_
嫫	mnld
朦	mnls
妈	mnm_
姆	mnmd
腼	mnmh
嬷	mnmm
牦	mnmo
媚	mno_
牡	mnt_
妹	mnw_
妙	mnx_
脉	mny_
绵	mob_
矛	mod_
买	moj_
绳	mok_
眉	mom_
缅	momh
缈	moms
母	moo_
幺	mood
毋	woo_
乜	mooo
缦	mor_
纱	mox_
獯	mqf_
猕	mqg_
猫	mql_
犸	mqm_
猸	mqo_
命	mra_
曼	mre_
侔	mren
暝	mrg_
冕	mri_
仫	mrie
昴	mrip
冒	mrm_
明	mr_
昧	mrw_
木	msi_
峁	msip
硭	msl_
礞	msls
码	msm_
岷	msmo
嵋	mso_
淼	mss_
坶	mtm_
墁	mtr_
鳗	mur_
芈	muu_
貌	mvb_
篾	mve_
貊	mvh_
迷	mvj_
觅	mvk_
艨	mvl_
貘	mvld
邈	mvv_
艋	mvz_
玟	mwd_
玫	mwf_
劢	mwl_
玛	mwm_
氓	mwmo
珉	mwmo2
邙	mwp_
瑁	mwr_
忙	mxd_
懵	mxl_
悯	mxm_
慢	mxr_
谧	myb_
酶	myf_
谂	myj_
谟	myl_
谩	myr_
谬	myu_
谜	myv_
醚	myvm
酩	myx_
寸	naj_
艹	nau_
瘁	nbd_
匆	nbf_
疟	nbh_
孬	nbn_
赐	nbr_
痤	nbrt
赦	ncf_
螬	nchr
辏	ncht
蛲	nchw
蜕	ncj_
赧	ncp_
徂	ncq_
蝻	ncs_
辗	vcs_
蚴	ncy_
螅	ncz_
奈	nde_
卒	ndn_
殂	ndq_
皴	neb_
攘	red_
捺	neds
摄	nee_
撵	nef_
擦	neg_
拧	negd
聍	negd2
搦	negj
措	neh_
攮	nehi
揍	zeh_
挠	reh_
挪	nei_
聪	nej_
捻	nejx
耐	nen_
拟	neor
操	nep_
挫	ner_
捏	nert
摧	nes_
撺	nex_
攒	zex_
恧	nexl
摊	tey_
淬	nfd_
滠	nfes
旎	nff_
辇	nffc
溺	nfg_
泞	nfgd
淙	nfgs
漕	nfh_
滋	nfj_
浓	nfn_
澡	nfp_
沧	nfr_
瀹	nfrl
涅	nfrt
牛	nfs_
泥	nfsb
涔	qfs_
爨	nft_
宁	ngd_
甯	ngx_
奏	nha_
黪	nhe_
囊	nhg_
虐	nhh_
刺	nhl_
曹	nhr_
昔	xhr_
黏	nhrv
拿	nhs_
灿	nhu_
褥	nic_
袅	nid_
馕	nih_
册	nii_
粤	nik_
衲	nin_
那	ni_
馁	niv_
兹	nja_
凝	njb_
镊	nje_
错	njh_
帻	zjh_
镎	njhs
凑	njht
铙	njhw
曾	njk_
锘	njl_
钥	njn_
钠	njnd
钕	njnh
锉	njr_
铌	njs_
钺	njw_
念	njx_
镍	njz_
曰	nke_
且	qke_
嗫	nkes
咛	nkgd
嘈	nkh_
囔	nkhi
哪	nki_
匿	nkl_
喏	rkl_
囡	nknh
哝	nknl
呶	nkny
呢	nks_
喃	nksg
啮	nkv_
呲	zkv_
廿	nla_
耨	nlc_
萃	nld_
萘	nlds
茨	nlj_
鹾	nljg
茑	nlna
艿	nlni
草	nlr_
苍	nlrp
苁	nlrr
蔫	ylv_
藏	nlw_
闹	nmd_
榱	nmdi
柰	nme_
骖	nmef
槽	nmh_
楱	nmht
阅	nmj_
睨	nmje
糍	nmjy
毳	nmm_
材	nmn_
枘	rmn_
栅	smn_
骢	nmnx
粗	nmq_
枞	nmr_
楠	nms_
糯	nmu_
粘	vmu_
糙	nmv_
睬	nmvm
樾	nmz_
丛	nna_
妁	nnb_
脑	nnd_
娘	nndg
腻	nne_
彩	nnf_
弩	nng_
颞	nnh_
腠	nnht
娜	nni_
脆	nnie
帑	nnj_
鼐	nnm_
驽	nnma
奶	nnn_
鹚	nnna
肭	nnnd
脓	nnnl
嬲	nnnn
胬	nnnr
雌	nnr_
脞	qnr_
嫩	nns_
妮	nnsb
腩	nnsg
脲	nnss
瓷	nnw_
努	nnl_
慈	nnx_
怒	nnxl
奴	nny_
孥	nnz_
肀	noa_
缯	noj_
纳	non_
纽	noo_
纵	nor_
猝	nqd_
狞	nqg_
猜	nqh_
猊	nqj_
蹙	nqk_
猱	nqm_
氖	nqn_
狃	nqo_
龠	nra_
侧	nrb_
曩	nrd_
隹	wrd_
佞	nre_
最	zr_
你	nri_
倪	nrj_
昕	nrju
侬	nrn_
偬	zrn_
催	nrs_
昵	nrsb
伲	nrsb2
汆	nrsl
暖	nrv_
恁	nrx_
慝	nrxl
傩	nry_
尼	nsb_
层	nse_
裁	nsg_
硇	nsi_
磁	nsj_
磋	nsjg
嵯	nsjg2
辞	nsl_
礤	nsli
崔	nsr_
岑	nsrj
矬	nsrt
碾	nsso
垴	ntd_
坭	nts_
蚕	ntv_
翠	nud_
霓	nuj_
鲵	nuje
鲶	nujx
鲇	nuu_
粲	nux_
策	nvh_
艚	nvhr
逆	nvj_
箬	nvl_
采	nvm_
篡	nvme
舱	nvr_
琮	nwg_
璁	nwn_
瑙	nwo_
璀	nws_
戚	qws_
璨	nwu_
恻	nxb_
窜	nxc_
惭	nxcj
恼	nxd_
悴	nxds
悦	nxj_
忖	nxn_
忸	nxo_
衄	nxot
怩	nxs_
懦	nxu_
孽	nxz_
酿	nyd_
酢	nyf_
醋	nyh_
谑	xyh_
诺	nyl_
讷	nyn_
词	nyo_
蹑	nze_
趣	qze_
跃	nzi_
趋	qzi_
蹉	nzjg
趑	zzj_
蹭	nzjr
臬	nzm_
蹿	nzx_
躜	nzxb
渥	ofs_
喔	oks_
耦	olu_
殴	oq_
鸥	oqn_
瓯	oqw_
尢	wai_
扌	paj_
丕	pba_
痞	pbb_
疱	pbbe
劈	pbd_
匍	pbfd
叛	pbfy
磐	pbhk
皤	pbi_
罴	pbj_
赔	pbl_
疲	pbo_
癖	pbs_
瓶	pbw_
痦	wbw_
蚍	pcb_
彦	ycf_
蟛	pcif
螵	pcx_
亠	tda_
讠	pdoo
扑	peb_
抛	pejl
披	peo_
聘	pey_
泡	pfb_
滂	pfdf
浦	pff_
旆	pffh
湓	pffm
沛	pfh_
澎	pfif
泮	pfj_
贫	pfk_
盆	pfm_
濮	pfrd
淠	pft_
庖	pg_
鼙	pgf_
审	pgs_
庄	pgt_
烹	phj_
鄱	pim_
襻	pims
饣	pioo
钋	pjb_
礻	sjb_
镤	pje_
铺	pjf_
镨	pjj_
钷	pjk_
铍	pjo_
帔	pjoy
丬	pju_
咆	pkb_
呸	pkba
匏	pkbe
匹	pke_
啪	pkeb
噗	pked
圃	pkf_
嘭	pki_
叵	pkk_
噼	pks_
嘌	pkx_
葩	plb_
苤	plba
耪	pld_
萍	plf_
蒎	plff
苹	plg_
剖	plk_
蓬	plv_
朴	pmb_
睥	pmf_
枰	pmg_
粕	pmi_
骈	pmj_
氆	pmjj
榀	pmk_
棚	pmn_
瞟	pmx_
攀	pmy_
胚	pnb_
牝	pnbi
嫔	png_
犏	pnh_
膨	pni_
胖	pnj_
姘	pnjk
胼	pnjk2
姗	pnn_
脬	pnv_
娉	pny_
爿	poa_
辔	poc_
疋	por_
缥	pox_
譬	ppd_
颦	ppf_
瓢	ppg_
颇	pph_
飘	ppi_
陪	ppl_
婆	ppnh
邳	ppp_
郫	pppu
甓	ppw_
翩	ppx_
狍	pqb_
乓	pqd_
氕	pqi_
仆	prb_
俳	pre_
凭	pri_
佩	prij
僻	prs_
俜	pry_
屁	psb_
砒	psbb
砰	psg_
碰	psjy
硼	psn_
毗	ptb_
坪	ptg_
圮	pti_
畔	ptj_
坡	pto_
忄	sud_
霈	puf_
鲆	pug_
攴	puy_
爬	pvb_
筢	pve_
迫	pvi_
笸	pvk_
盘	pvm_
篷	pvv_
貔	pvx_
珀	pwi_
琶	pww_
琵	pwwb
怦	pxg_
评	pyg_
谝	pyh_
谱	pyj_
醅	pyl_
趴	pzb_
蹼	pze_
蹁	pzh_
七	qao_
瘸	qbj_
鼽	qbji
鬈	qbjp
癯	qbm_
赇	qbq_
痊	qbr_
蜞	qchb
螓	qchh
蚯	qcja
蜣	qcjh
虬	qco_
衢	qcq_
蛆	qcqa
蛐	qcqg
龋	qcu_
蛴	qcw_
犬	qdd_
弃	qde_
牵	qdg_
祺	qdh_
祁	qdp_
祗	qds_
祛	qdt_
招	ved_
亓	qef_
掮	qeh_
掐	qei_
扦	qeis
揿	qej_
撬	qem_
擒	qerl
拴	qerw
捎	qeu_
示	qex_
汔	qffi
旗	qffq
潜	qffr
清	qfh_
淇	qfhb
溱	qfhh
乞	qfi_
泅	qfk_
漆	qfm_
沏	qfq_
渠	qfu_
沁	qfx_
鞠	qgb_
鞫	qgby
庆	qgd_
巧	qgh_
褰	qghi
搴	qghs
寝	qgj_
跫	qgk_
邛	qgp_
銎	qgr_
敲	qgu_
鞘	sgu_
虔	qhd_
黥	qhdx
黢	qhe_
秋	qhh_
秦	qhi_
启	qhk_
妻	qhnh
黔	qhr_
炝	qhrp
翘	qhw_
綮	qhwm
襁	qig_
郄	qih_
卿	qio_
欠	qir_
裙	qiy_
丘	qja_
衾	qjd_
券	qjf_
锲	qjfd
拳	qjfs
镪	qjgs
凄	qjh_
锹	qjhh
锖	qjhn
羌	qjho
钦	qji_
铅	yji_
歉	qjir
钎	qjis
群	qjj_
锵	qjjn
勤	qjl_
劬	qjli
劁	qjlj
铨	qjr_
擎	qjs_
酋	qjy_
嗪	qkh_
圊	qkhn
器	qkk_
唼	qkl_
团	tk_
囚	qkr_
噙	qkrl
吱	qks_
嘁	qkw_
吣	qkx_
蕖	qlf_
葜	qlfd
茕	qlg_
麒	qlh_
蓁	vlh_
萋	qlhn
芊	qli_
荨	qlin
芑	qlio
芡	qlir
芹	qlj_
葺	qlk_
颧	qlke
苘	qlkk
苣	qlko
妾	qln_
耆	vlr_
芩	qlrj
蘧	qlv_
茜	qlx_
荞	qly_
骐	qmhb
楸	qmhh
杞	qmi_
驺	zmi_
榷	qmjh
驱	qmk_
橇	qmm_
阒	qmmq
枪	qmr_
麴	qmrj
檎	qmrl
桤	qms_
枝	vms_
樯	qmt_
瞧	qmv_
樵	qmvj
栖	qmx_
桥	qmy_
糗	qmz_
戗	qng_
肷	qni_
胜	qnn_
嫱	qnt_
脐	qnw_
己	qoa_
巯	qog_
绻	qoj_
缱	qov_
戕	qpg_
切	qqd_
裘	qqdi
氰	qqh_
欺	qqi_
犰	qqj_
柒	qqm_
氍	qum_
娶	qqn_
氢	qqo_
邱	qqpu
悫	qqx_
綦	qqy_
禽	qrd_
晴	qrh_
佥	qrha
倩	qrhn
侵	qri_
仟	qris
倾	qro_
俅	qrq_
氽	trs_
曲	qr_
俏	qru_
岍	qsa_
磲	qsf_
碛	qsh_
硗	qshw
岂	qsi_
屺	qsio
躯	qsk_
岖	qski
声	qso_
砌	qsq_
岐	qss_
罄	qssf
磬	qsss
謦	qssy
雀	qsu_
峭	qsun
硝	xsu_
支	qsy_
憩	qszx
畎	qtd_
圻	qtj_
墙	qtt_
畦	qttt
鳅	quh_
鲭	vuh_
箝	qveg
迄	qvf_
筇	qvg_
遽	uvh_
迁	qvi_
遒	qvj_
箧	qvk_
椠	qvm_
逑	qvq_
筌	qvr_
歧	qvs_
遣	qvv_
戌	qwa_
琼	qwd_
琦	qwdk
琪	qwh_
璩	qwhs
琴	qww_
悛	qxe_
窍	qxg_
愀	qxh_
慊	qxj_
惬	qxk_
觑	qxke
穷	qxl_
削	sxl_
鹊	qxn_
窃	qxq_
恰	qxr_
覃	qxrs
忮	qxs_
怯	qxt_
悄	qxu_
悭	qxut
憔	qxv_
讫	qyfi
谦	qyj_
劝	qyl_
羟	qyo_
诠	qyr_
诮	qyu_
谴	qyv_
谯	qyvj
愆	qyx_
跷	qzh_
趿	tzi_
趄	qzq_
跄	qzr_
蹊	qzv_
轫	rcd_
蝾	rcl_
辱	rcn_
蚋	rcnd
蚺	rcr_
蠕	rcu_
禳	rdd_
瓤	rdk_
揉	rem_
扔	ren_
溽	rfc_
汝	rfn_
洳	rfnk
乳	rfo_
溶	rfx_
戎	rgh_
冗	rgi_
鞣	rgm_
穰	rhd_
稔	rhj_
熔	rhx_
饶	rih_
然	riq_
饪	riqa
衽	riqa2
襦	riue
镶	rjd_
铷	rjn_
嚷	rkd_
嚅	rku_
蓐	rlc_
茸	rle_
若	rlh_
荛	rlhw
茹	rln_
芮	rlnd
葚	rlq_
荏	rlr_
苒	rlrh
蕤	rls_
薷	rlu_
蓉	rlx_
闰	rma_
桡	rmh_
糅	rmm_
榕	rmx_
朊	rne_
娆	rnh_
妊	rnq_
肉	rnr_
缛	roc_
纫	rod_
绒	rog_
狨	rqg_
仞	rrd_
仁	rre_
偌	rrl_
仍	rrn_
儒	rru_
忍	rrx_
惹	rrxl
韧	rwd_
颥	rxh_
让	rys_
蹂	rzm_
豕	sai_
束	sak_
十	sau_
痧	sbf_
赊	sbr_
赎	sbs_
疝	sbu_
厍	scc_
蟀	scd_
轼	sce_
顺	sch_
厦	xch_
剩	scl_
蛸	scu_
蜃	scv_
煞	scw_
螫	scwc
蟮	scy_
殇	sdf_
殊	sdi_
商	sdj_
视	sdk_
召	vdk_
奢	sdl_
神	sds_
殖	vds_
社	sdt_
爽	sdy_
蜀	seb_
擅	sed_
摔	seds
拭	seeg
折	sej_
署	sel_
耍	sen_
抒	seu_
授	sev_
矢	sfd_
深	sfg_
渖	sfgs
潲	sfh_
澍	sfi_
潸	sfl_
沭	sfm_
汤	sfo_
湿	sfr_
汁	sfsg
涮	sfsl
漱	sfsq
汕	sfu_
濯	sfuv
室	sga_
守	sgn_
庶	sgnj
熵	shd_
烧	shh_
炻	shhk
煽	shhu
秫	shm_
寿	shn_
黍	shr_
稍	shu_
歙	xhu_
扇	shx_
衫	sifi
升	sig_
甩	sih_
杀	sim_
氏	sio_
蚀	siv_
朱	siw_
殳	siy_
朔	sja_
铈	sjd_
镯	sje_
觞	sjf_
钐	sjfi
首	sjh_
冼	sjie
鼠	sjo_
兽	sjt_
吮	ske_
吲	skg_
嘘	skh_
孰	skk_
嗜	skl_
啥	skr_
唑	zkr_
呻	sks_
唰	sksl
噬	skv_
哂	skx_
苕	sld_
薯	sle_
芟	sli_
蓍	sll_
莘	xll_
蔬	slo_
莳	slr_
麝	sls_
闩	sma_
睡	smc_
柿	smd_
檀	tmd_
梳	smdf
杉	smf_
骟	smh_
枢	smk_
鹬	umk_
椹	smq_
闪	smr_
栓	smrw
驶	sms_
杼	smuj
瞬	smv_
娠	snc_
始	sne_
婶	sng_
姝	sni_
媵	snj_
删	snl_
牲	snna
姓	xnn_
世	sno_
腧	snr_
肢	vns_
孀	snu_
膳	sny_
尸	soa_
虱	soi_
书	soo_
绅	sos_
纾	sou_
绱	souk
绡	xou_
疏	sov_
绶	sovy
缮	soy_
狩	sqg_
歃	sqj_
甚	sqo_
猞	sqr_
狮	squ_
俞	sra_
曙	sre_
佘	srex
伤	srf_
舍	srg_
晌	sri_
使	srl_
暑	srlr
什	srs_
仕	srsa
伸	srsg
侍	srt_
申	sru_
倏	sruq
傻	srx_
晒	srxh
恕	srxl
士	ssa_
裟	ssd_
弑	sse_
矧	ssg_
硕	ssh_
鲨	ssi_
熟	ssj_
刷	ssjl
屎	xsj_
贳	ssk_
眚	ssm_
鄯	ssp_
砷	sss_
舐	ssso
塾	sst_
畲	ssth
甥	sstl
峙	vst_
属	ssu_
舒	ssuj
叔	ssx_
砂	ssxi
埘	str_
埏	stv_
师	sua_
震	suc_
赏	sug_
豫	sui_
帅	suj_
山	su_
霎	sul_
霜	sum_
毹	sumo
鲺	suo_
鲥	sur_
肾	suy_
鳝	suyk
竖	suyl
誓	svd_
笤	svdk
逝	sve_
舜	svg_
筮	svgr
透	svh_
艏	svj_
售	svk_
势	svl_
劭	svli
述	svm_
笙	svn_
巡	svo_
邵	svp_
筛	svu_
舢	svuk
艄	svun
筲	svun2
戍	swd_
恂	sxb_
慑	sxe_
恃	sxt_
慎	sxv_
酾	sya_
韶	syd_
试	sye_
设	syi_
善	syj_
识	syk_
剡	syl_
谁	syr_
诗	sytn
讪	syu_
双	syy_
屯	tak_
痰	tbh_
痛	tbo_
疼	tbw_
瘫	tby_
龆	tcd_
螗	tcg_
徒	tct_
螳	tcu_
唾	tdc_
彤	tdf_
套	tdh_
祧	tdj_
亭	tdk_
剃	tdl_
臀	tdn_
鹈	tdna
餮	tdr_
殄	tdrf
嚏	tds_
掏	teb_
探	teg_
搪	tegk
拓	teh_
托	teiq
捅	teo_
推	ter_
掭	tet_
挺	tev_
挞	tevd
抟	vevd
忒	tex_
淘	tfb_
汰	tfd_
溏	tfgk
涕	tfj_
溻	tfru
湍	tfs_
添	tft_
滔	tfv_
庹	tgn_
唐	tgo_
庭	tgv_
饕	thh_
炎	yhh_
秃	thi_
煺	thv_
剔	til_
饧	tio_
乇	tiq_
袒	tir_
裼	xir_
饨	tit_
褪	tiv_
钛	tjd_
铽	tje_
誊	tjf_
铴	tjfo
锬	tjh_
铁	tji_
锑	tjj_
铜	tjk_
贪	tjkr
钽	tjr_
锡	xjr_
钍	tjt_
帖	tju_
镗	tjut
镇	vjv_
凸	tka_
吴	wka_
啕	tkb_
啼	tkd_
鼍	tkk_
田	tkt_
吐	tkta
嗵	tkv_
图	tkw_
萄	tlb_
苔	tle_
薹	tli_
菟	tliu
萜	tlj_
茼	tlk_
藤	tln_
耥	tlu_
莛	tlv_
蕈	tlx_
柝	tmc_
驼	tmg_
毯	tmh_
梯	tmjo
桃	tmj_
眺	tmji
瞳	tml_
桶	tmo_
椭	tmp_
榻	tmr_
阗	tmv_
闼	tmvd
梃	tmvr
婷	tnd_
肽	tndd
胎	tne_
鸵	tng_
脱	tnj_
姚	ynj_
腾	tnjm
滕	tnjs
膛	tnu_
腆	tnub
腿	tnv_
妩	tnw_
绣	toh_
绨	toj_
缇	tor_
绦	tow_
停	trd_
暾	trx_
昙	tre_
仝	trga
偷	trr_
傥	trux
佟	trw_
甜	tsg_
砣	tsgb
炭	tsh_
屠	tsl_
砼	tsr_
碳	tss_
屉	tsso
舔	tst_
躺	tsu_
坍	ttd_
畋	ttf_
塘	ttg_
颓	tthb
炱	tthc
堍	tti_
吞	ttk_
疃	ttll
邰	ttp_
坦	ttr_
忝	ttx_
鲐	tue_
棠	tug_
霆	tuv_
鲦	tuw_
迢	tvd_
箨	tve_
退	tvg_
鼗	tvi_
逃	tvj_
妥	tvn_
廷	tvq_
逖	tvqh
途	tvr_
遢	tvru
艇	tvv_
瑭	twg_
韬	twv_
悌	txj_
窕	txji
恬	txq_
惕	txr_
愉	uxr_
窀	txt_
恸	txy_
酞	tyd_
醣	tyg_
讨	tyn_
郯	typ_
醍	tyr_
谕	uyr_
酴	tyrm
羰	tys_
谭	tyx_
恿	tyxl
跆	tze_
跎	tzg_
蹋	tzru
踏	tzs_
雨	ua_
王	uat_
瘀	ubf_
疽	ubq_
瘐	ubu_
龃	ucq_
蝓	ucr_
龉	ucw_
衙	ycw_
掬	uebm
拒	uek_
鸢	uen_
浴	ufb_
舆	ufc_
污	ufe_
淤	uff_
沮	ufq_
渝	ufr_
於	ufrj
飓	ufu_
粥	ugm_
鹆	ugn_
宇	ugu_
庾	uguc
寓	ugud
宛	ugx_
燠	uhi_
虞	uhk_
租	uhq_
煜	uhr_
煨	uht_
裕	uib_
饫	uii_
禹	uik_
裾	uis_
舁	ujg_
钜	ujk_
锔	ujs_
钰	ujw_
唷	ukd_
咀	ukq_
喻	ukr_
圉	ukt_
吁	uku_
喁	yku_
圄	ukw_
菸	ulf_
菹	ulfq
菀	ulg_
莒	ulk_
蔚	uls_
芋	ulu_
萸	uluc
蓣	ulue
苑	ulx_
驹	umb_
毓	umd_
阈	umg_
橘	ummk
榆	umr_
椐	ums_
梧	umw_
榉	umx_
栩	xmx_
驭	umy_
腴	unu_
犋	unub
妤	unuj
聿	uoe_
狙	uqq_
雎	uqr_
狳	uqrm
狱	uqy_
昱	urd_
禺	urk_
伛	urki
俣	urkt
倨	urs_
俱	uru_
峪	usb_
屦	usc_
矩	usk_
嵛	usr_
尉	wss_
屿	usu_
雩	uue_
预	uuh_
欤	uuir
觎	uuk_
剧	uul_
盂	uum_
榘	uumc
鄹	uup_
愈	uux_
愚	uuxl
鬻	uva_
迂	uvu_
竽	uvuj
熨	uwh_
吾	uwk_
瑜	uwr_
琚	uws_
誉	uxd_
窳	uxg_
窭	uxm_
惧	uxu_
醵	uyh_
讵	uyk_
郁	uyp_
谀	uyu_
踞	uzs_
踽	uzu_
丈	vai_
赘	vak_
赈	vbc_
账	vbv_
疰	vbd_
痄	vbf_
贮	vbg_
瘃	vbh_
赚	vbj_
齄	vbm_
旨	vbr_
痔	vbs_
痣	vbsx
瘴	vby_
征	vca_
蛭	vcat
轾	vcat2
蛀	vcd_
辄	vce_
蚱	vcf_
蛛	vci_
斩	vcj_
轵	vck_
赭	vcl_
皱	vcoy
昼	vcr_
轸	vcrf
蜘	vcsk
辙	vcu_
蚤	vcv_
轴	vcy_
蚰	vcyg
蟑	vcys
螽	vdc_
州	vdi_
禚	vdj_
之	vdo_
嘱	vdsu
坠	vdt_
祯	vdu_
衷	vdv_
祉	vdva
指	veb_
振	vec_
拙	vecg
摘	vedg
拄	vedw
摭	vegj
掷	vegp
挣	vei_
黹	veju
职	vek_
捉	vekr
撞	vel_
拯	vela
揸	vem_
扎	veo_
置	ves_
搌	veso
罩	veu_
擢	veuv
抓	vev_
挝	wev_
执	vew_
锺	vfc_
注	vfd_
沼	vfdk
浙	vfej
旃	vff_
涨	vfg_
涿	vfhl
洙	vfi_
浞	vfk_
渚	vfl_
渣	vfm_
卮	vfp_
潴	vfqv
质	vfs_
竹	vfu_
爪	vfuc
乍	zfu_
洲	vfv_
浊	vfvh
漳	vfy_
冢	vghl
鹧	vghn
郑	vgp_
宙	vgy_
灼	vhb_
炷	vhd_
炸	vhf_
秩	vhi_
稚	vhr_
豸	vid_
馔	vie_
帚	vig_
炙	vih_
舟	vii_
周	vit_
钲	vja_
铡	vjb_
帐	vjc_
状	vjd_
兆	vje_
鲞	vjf_
铸	vjh_
铮	vji_
帙	vjif
铢	vjiw
觯	vjj_
帜	vjk_
钊	vjlj
盏	vjm_
妆	vjn_
鸩	vjna
准	vjr_
锥	vjrh
针	vjs_
壮	vjsa
帧	vju_
钟	vjvg
幛	vjy_
铀	yjy_
啭	vkc_
哳	vke_
咋	vkf_
咤	vkg_
啄	vkh_
吒	vkiq
咒	vkk_
蒸	vlc_
茁	vlcg
麈	vld_
蔗	vlg_
苎	vlga
茱	vli_
荮	vlo_
站	vlu_
芝	vlv_
芷	vlva
蘸	vly_
桎	vma_
驻	vmd_
柱	vmdw
栀	vmf_
柞	zmf_
桩	vmg_
柘	vmh_
榛	vmhh
株	vmi_
睁	vmio
眨	vmiv
瞻	vmiy
栈	vmjd
枳	vmk_
栉	vml_
札	vmo_
骤	vmq_
骓	vmrh
瞩	vmsu
桢	vmub
毡	vmuk
棹	vmuz
杖	vmv_
榨	vmx_
樟	vmy_
柚	ymy_
槠	vmyv
脂	vnb_
砦	vnh_
朕	vnj_
肘	vnn_
胗	vnr_
肿	vnv_
膣	vnx_
嫜	vnys
彘	vob_
绽	vog_
纣	von_
纸	vos_
缒	vovi
终	vow_
骘	vpb_
阵	vpc_
陬	vpe_
狰	vqi_
猪	vql_
獐	vqy_
侄	vra_
住	vrd_
昭	vrdk
伫	vrg_
债	vrh_
仉	vri_
侏	vriw
众	vrr_
侦	vru_
倬	vruz
仲	vrv_
仗	vrvc
颛	vse_
砟	vsf_
栽	vsg_
碡	vsh_
跖	vshk
峥	vsi_
斟	vsj_
知	vsk_
咫	vskb
直	vsu_
砧	vsuk
砖	vsv_
整	vsw_
肇	vswu
志	vsx_
磔	vsxm
嶂	vsys
畛	vtr_
埴	vts_
址	vtv_
止	vua_
掌	vug_
贞	vuk_
桌	vur_
卓	vura
真	vvb_
装	vvd_
奘	zvd_
籀	vvel
笮	zvf_
致	vvf_
彰	vvfi
繇	vvfx
战	vvg_
筑	vvgf
遮	vvgj
臻	vvh_
箦	vvhb
筝	vvio
照	vvj_
煮	vvjl
哲	vvk_
贽	vvkr
箸	vvl_
橥	vvmc
鸷	vvn_
篆	vvo_
鄣	vvpu
邾	vvpu2
智	vvr_
挚	vvsj
蜇	vvv_
笊	vvvc
舯	vvvg
蛰	vvvh
忠	vvx_
翥	vvxx
絷	vvy_
舳	vvyg
斋	vwh_
琢	zwh_
珍	vwr_
璋	vwy_
怔	vxav
怍	vxf_
酯	vyb_
酌	vybd
谆	vyd_
谪	zyd_
诏	vydk
诹	vye_
诈	vyf_
诼	vyh_
诛	vyi_
诤	vyio
谵	vyiy
胄	vyn_
酎	vynd
诊	vyr_
章	vys_
踵	vzc_
躅	vze_
踬	vzf_
踯	vzg_
趾	vzva
武	wae_
兀	waeo
瓦	wao_
五	wau_
歪	wba_
痿	wbh_
瘟	wbr_
卧	wcb_
蚊	wcd_
蜿	wcg_
蜗	wck_
蜈	wckt
辋	wckw
戊	wco_
微	wcs_
龌	wcsv
豌	wdg_
亡	wdo_
挽	wei_
未	weu_
捂	wew_
挖	wex_
舞	wfh_
洧	wfhn
沃	wfi_
涠	wfkw
潍	wfo_
温	wfr_
午	wfs_
渭	wftn
璺	wftu
浯	wfw_
寤	wgj_
魍	wgk_
巫	wgr_
鞋	wgt_
瓮	wgw_
庑	wgwo
翁	wgx_
稳	whc_
烷	whg_
軎	whk_
炜	whw_
焐	whwk
夭	wid_
弯	wig_
丸	wjd_
幄	wjs_
钨	wjw_
帏	wjwg
吻	wkb_
园	wke_
嗡	wkg_
网	wki_
罔	wkj_
唯	wkr_
喂	wkt_
呜	wkwa
薇	wlc_
蕹	wld_
蓊	wlgu
萎	wlh_
莴	wlk_
苋	xlk_
蕴	wlo_
苇	wlw_
芄	wlwd
葳	wlwn
杌	wmae
闻	wme_
眼	wmg_
阌	wmv_
闱	wmwg
骛	wmwm
鹜	wmwn
肟	wne_
婉	wng_
腕	wngp
娲	wnk_
腽	wnr_
娓	wns_
牾	wnw_
纹	wod_
绾	wog_
纬	wow_
纨	wowd
阢	wpa_
隈	wpt_
猬	wqt_
旺	wra_
侮	wrf_
仵	wrfs
倭	wrh_
晚	wri_
偎	wrt_
伟	wrw_
伍	wrwa
晤	wrwk
佤	wrwo
嵬	wsf_
碗	wsg_
巍	wsw_
韪	wswg
鼯	wswk
崴	wswn
圬	wte_
畹	wtg_
畏	wth_
圩	wtu_
坞	wtw_
雯	wud_
鲔	wuh_
迕	wvf_
箢	wvg_
逶	wvh_
艉	wvs_
威	wwa_
玩	wwe_
魏	wwf_
琬	wwg_
剜	wwl_
刎	wwlj
望	wwn_
鹉	wwna
妄	wwnh
邬	wwp_
鋈	wwr_
韫	ywr_
玮	www_
忘	wwx_
慰	wwxl
紊	wwy_
忤	wxf_
惋	wxg_
窝	wx_
惘	wxk_
惟	wxr_
愠	yxr_
悟	wxw_
怃	wxwo
诬	wyg_
诿	wyhn
谓	wyt_
壅	yyt_
西	xak_
痃	xbd_
兮	xbh_
匈	xbi_
痫	xbm_
髹	xbr_
癣	xbu_
徇	xcb_
循	xcf_
蟋	xci_
蟓	xciu
衔	xcj_
蚬	xck_
厢	xcm_
蜥	xcmj
徐	xcr_
祆	xda_
殉	xdb_
禊	xdf_
禧	xdi_
祥	xdj_
享	xdk_
襄	xdki
亵	xdv_
玄	xdy_
巽	xee_
揎	xeg_
撷	xei_
玺	xew_
擤	xez_
洵	xfb_
旋	xff_
漩	xffp
泻	xfg_
渲	xfgd
须	xfh_
罅	xfhh
卸	xfhp
洗	xfi_
浠	xfib
汹	xfik
浔	xfin
淆	xfiy
熏	xfj_
洋	yfj_
潇	xfl_
湘	xfm_
淅	xfmj
汛	xfo_
瀣	xfu_
溆	xfuy
溪	xfv_
汐	xfx_
宣	xga_
弦	xgd_
宪	xgi_
庠	xgj_
廨	xgjn
席	xgn_
靴	xgr_
庥	xgrm
写	xgu_
序	xguj
宵	xgun
魈	xgun2
炫	xhd_
雄	xhe_
虚	xhea
煊	xhg_
稀	xhi_
烯	xhib
歇	xhir
秀	xhn_
黠	xhs_
翕	xhx_
燮	xhy_
熄	xhz_
希	xih_
爻	xiic
饷	xiik
馐	xijc
凶	xik_
囟	xiki
血	xim_
枭	ximc
悉	ximx
寻	xin_
先	xit_
象	xiu_
袖	xiyg
兴	xjb_
铉	xjdy
效	xjf_
镟	xjfp
泶	xjg_
锈	xjh_
羞	xjhc
铣	xjie
欣	xji_
鑫	xjj_
锨	xjjq
锌	xjl_
旭	xjrh
销	xju_
蟹	xjv_
羲	xjwf
喧	xkg_
哓	xkhw
响	xki_
唏	xkib
吸	xkic
嘻	xkik
匣	xkj_
刑	xkl_
哮	xklz
咻	xkr_
呀	xky_
嗅	xkz_
荀	xlb_
荇	xlc_
蓰	xlcr
袭	xld_
薤	xldj
萧	xle_
薰	xlf_
萱	xlg_
蓿	xlgb
芎	xlgo
荥	xlgs
莠	xlh_
薛	xli_
勰	xlls
葙	xlmm
薪	xlq_
藓	xlu_
蓄	xlx_
芗	xlxi
芯	xlxl
孝	xlz_
檄	xmb_
驯	xmc_
骧	xmdi
楔	xmf_
械	xmg_
楦	xmgd
瞎	xmgk
朽	xmh_
骁	xmhw
橡	xmi_
杏	xmk_
枵	xmkh
闲	xmm_
糈	xmp_
榭	xms_
樨	xmsn
榍	xmsx
籼	xmu_
盱	xmuj
粞	xmxh
葸	xmxl
胸	xnb_
腺	xnbs
献	xnd_
嬉	xni_
熊	xnj_
嫌	xnjh
胁	xnl_
膝	xnm_
娴	xnmm
婿	xnp_
腥	xnr_
媳	xnz_
绚	xob_
缬	xoie
线	xoj_
习	xoja
绪	xol_
缃	xom_
续	xos_
细	xot_
陷	xpi_
胥	xpn_
隰	xprj
隙	xpx_
狭	xqf_
狎	xqj_
猩	xqr_
猃	xqrh
氙	xqu_
偕	xrb_
显	xre_
儇	xrei
侠	xrf_
曛	xrfj
暄	xrg_
晓	xrh_
像	xri_
僖	xrik
曦	xrj_
煦	xrjj
休	xrm_
晰	xrmj
星	xrn_
修	xru_
仙	xruk
峋	xsb_
屣	xsc_
硖	xsf_
碹	xsg_
崤	xsi_
岘	xsk_
馨	xss_
犀	xssn
屑	xsun
鼷	xsv_
硒	xsx_
矽	xsxd
岫	xsy_
岈	xsyi
墟	xth_
埙	xtk_
饩	xuf_
雪	xui_
鲟	xuin
鲜	xuj_
肖	xun_
霞	xuo_
霄	xuu_
鳕	xuui
贤	xuy_
叙	xuyc
舷	xvd_
箫	xvn_
笑	xvi_
筅	xvie
邂	xvj_
逊	xvz_
箱	xvm_
迅	xvo_
遐	xvoy
筱	xvr_
貅	xvrm
暹	xvrv
逍	xvu_
舾	xvx_
奚	xvy_
咸	xwa_
璇	xwf_
顼	xwh_
觋	xwk_
瑕	xwo_
峡	xxf_
惜	xxh_
恤	xxi_
皙	xxir
欷	xxir2
懈	xxj_
熹	xxjd
衅	xxjh
忻	xxju
窨	yxl_
鹇	xxn_
鸺	xxna
飨	xxr_
惺	xxrs
型	xxt_
悻	xxtg
想	xxx_
穸	xxxd
悬	xxxl
询	xyb_
谐	xybb
训	xyc_
醯	xyd_
醺	xyf_
酰	xyi_
酗	xyik
歆	xyir
详	xyj_
勋	xyl_
讯	xyo_
醑	xypn
谢	xys_
谖	xyv_
翔	xyx_
诩	xyxx
躞	xzh_
跹	xzv_
酉	yak_
牙	yao_
痖	yba_
婴	ybb_
罂	ybbf
瘿	ybbn
痈	ybi_
痒	ybjh
庸	ybo_
疡	yboi
瘾	ybp_
颍	ybs_
疣	yby_
螈	ycc_
厌	ycd_
衍	ycfc
蝣	ycfz
蚓	ycg_
徉	ycj_
蛘	ycjh
蝇	yck_
蛹	yco_
魇	ycq_
厣	ycqj
餍	ycqs
雁	ycr_
赝	ycrb
压	yct_
辕	ycti
徭	ycvf
蚜	ycy_
奄	ydd_
殒	ydk_
永	ydo_
雍	ydx_
殃	ydy_
撄	yeb_
掩	yed_
罨	yedd
云	yee_
允	yeeo
拥	yei_
揠	yek_
扬	yeo_
摇	yevf
涯	yfc_
淹	yfd_
沅	yfe_
滟	yffe
演	yfg_
沿	yfi_
艳	yfib
渊	yfiu
殷	yfiy
漾	yfjy
滢	yfl_
潆	yflm
淫	yfv_
瀛	yfw_
湮	yfx_
油	yfy_
泱	yfyc
泳	yfyl
寅	ygh_
宥	yghn
冤	ygi_
宴	ygr_
引	ygu_
耀	yguv
鞅	ygy_
尧	yha_
焰	yhi_
烊	yhj_
右	yhk_
烟	yhkd
炀	yho_
友	yhy_
秧	yhyc
肴	yih_
饮	yii_
釉	yim_
胤	yiy_
银	yjg_
镛	yjgo
养	yjh_
羊	yjhg
铕	yjhn
铟	yjk_
鸭	yjn_
鄞	yjp_
郓	yjpu
丫	yju_
恙	yjw_
猷	yjyq
嘤	ykb_
因	ykd_
央	ykdc
唁	ykdk
囿	ykh_
圆	ykk_
喑	yklr
哟	yko_
郾	ykrp
吆	ykyd
咏	ykyl
呦	ykyl2
耘	yle_
芸	ylee
兖	ylee2
芫	ylee3
荧	ylg_
萤	ylgc
蓥	ylgj
萦	ylgm
莺	ylgn
茔	ylgt
莹	ylgu
茚	yli_
茵	ylk_
荫	ylp_
莸	ylq_
音	ylr_
英	yly_
芽	ylyi
闫	yma_
桠	ymae
樱	ymb_
睚	ymc_
阉	ymd_
阎	ymi_
楹	ymn_
杨	ymo_
橼	ymos
验	ymr_
杳	ymrh
娅	yna_
妍	ynah
臃	yndv
燕	ynk_
姻	ynkd
胭	ynkd2
媛	ynv_
嫣	ynvj
腰	ynx_
孕	ynz_
尹	yoa_
缨	yob_
纭	yoe_
邕	yokb
缘	yoo_
隐	ypc_
牖	yph_
陨	ypk_
阳	ypr_
氩	yqa_
狺	yqd_
狁	yqe_
氧	yqj_
氤	yqk_
氲	yqr_
猿	yqt_
昀	yrb_
晕	yrg_
晏	yrgn
佑	yrh_
俨	yrhc
侑	yrhn
佣	yrih
佯	yrj_
偃	yrk_
俑	yro_
攸	yru_
曜	yruv
优	yry_
映	yryc
伢	yryi
崦	ysd_
岩	ysh_
砚	ysk_
鼹	ysr_
崾	ysx_
幽	ysy_
鼬	ysyg
砑	ysyi
垣	yta_
塬	ytc_
墉	ytgo
袁	ytk_
堰	ytkn
堙	ytx_
霪	yuf_
鳙	yug_
卣	yuk_
鳐	yuv_
邀	yvb_
远	yve_
鹞	yvf_
爰	yvhy
迎	yvi_
延	yviv
舀	yvj_
遥	yvv_
筵	yvvv
迓	yvy_
璎	ywb_
琰	ywhh
珧	ywj_
嬴	ywk_
瑛	ywl_
瑶	ywv_
琊	ywy_
恹	yxc_
恽	yxg_
夤	yxgb
慵	yxgo
怨	yxp_
鸳	yxpn
窑	yxw_
忧	yx_
怏	yxyc
窈	yxyl
韵	yyb_
谚	yyc_
尤	yyd_
酝	yye_
诱	yyh_
颜	yyhb
酽	yyhc
鼋	yyk_
勇	yyl_
幼	yyli
鹰	yyn_
鸦	yyna
鸯	yyna2
鹦	yyna3
膺	yynh
谳	yynq
邮	yyp_
郧	yypu
鄢	yypu2
雅	yyr_
饔	yyrl
谣	yyv_
悠	yyx_
讶	yyy_
眢	yzp_
赃	zbg_
贼	zbgh
鬃	zbgs
赠	zbj_
皂	zbq_
髭	zbv_
辎	zco_
昝	zcr_
仄	zcrc
祚	zdf_
凿	zej_
撙	zejn
罾	zejr
拶	zeo_
攥	zev_
滓	zfg_
淄	zfo_
泽	zfy_
灾	zgd_
宗	zge_
宰	zgl_
座	zgr_
左	zhg_
秭	zhi_
枣	zhj_
灶	zht_
孜	zzf_
锃	zjkw
锱	zjo_
钻	zju_
尊	zjy_
唣	zkb_
啧	zkh_
咱	zki_
匝	zkj_
咂	zkk_
嘴	zkn_
噪	zkp_
赜	zku_
葬	zle_
藻	zlf_
耔	zlz_
糌	zmc_
棕	zmg_
粽	zmgs
糟	zmh_
樽	zmj_
梓	zml_
驵	zmq_
眦	zmv_
訾	znd_
胙	znf_
脏	zng_
腙	zngs
姊	zni_
觜	zniy
咨	znk_
赀	znkr
姿	znn_
恣	znx_
紫	zny_
综	zog_
缁	zoo_
甾	zot_
缵	zox_
阼	zpf_
昃	zrc_
昨	zrf_
做	zrg_
佐	zrh_
坐	zrr_
俎	zrrq
早	zrs_
仔	zrz_
哉	zsgk
嵫	zsj_
砸	zsk_
崽	zst_
走	ztu_
鲰	zue_
鳟	zuj_
舴	zvfe
迮	zvfe2
遭	zvh_
簪	zvhr
笫	zvi_
遵	zvj_
纂	zvm_
暂	zvr_
錾	zvri
怎	zvx_
瓒	zwx_
憎	zxj_
谘	zyn_
诅	zyq_
躁	zzp_
甑	zzw_
趱	zzx_
孳	zzz_
